0 0 0 0 0 0 0 0 0 0 0 0 0 0 1 7 8 9 1 0 0 0 0 0 0 0 0 0 0 0 0 0 0 0 0 0 0 0 0 0 0 0 0 0 0 0 0 0 0 0 
0 0 0 0 0 0 0 0 0 0 0 0 0 0 1 7 8 9 1 0 0 0 0 0 0 0 0 0 0 0 0 0 0 0 0 0 0 0 0 0 0 0 0 0 0 0 0 0 0 0 
0 0 0 0 0 0 0 0 0 0 0 0 0 0 1 7 8 9 1 0 0 0 0 0 0 0 0 0 0 0 0 0 0 0 0 0 0 0 0 0 0 1 1 1 1 1 1 1 1 0 
0 0 0 0 0 0 0 0 0 0 0 0 0 0 1 7 8 9 1 0 0 0 0 0 0 0 0 0 0 0 0 0 0 0 0 0 0 0 0 0 0 1 2 2 2 2 2 2 1 0 
0 0 0 1 1 1 1 1 1 1 1 1 1 1 1 7 8 9 1 1 1 1 1 1 1 1 1 1 1 1 1 1 1 0 0 0 0 0 0 0 0 1 3 3 3 3 3 3 1 0 
0 0 0 1 2 2 2 2 2 2 2 2 2 2 2 7 8 9 2 2 2 2 2 2 2 2 2 2 2 2 2 2 1 0 0 0 0 0 0 0 0 1 4 5 5 5 5 6 1 0 
0 0 0 1 3 3 3 3 3 3 3 3 3 3 3 7 8 9 3 3 3 3 3 3 3 3 3 3 3 3 3 3 1 0 0 0 0 0 0 0 0 1 7 20 21 21 22 9 1 0 
0 0 0 1 4 5 5 5 5 5 5 5 5 5 5 13 8 14 5 5 5 5 5 5 5 5 5 5 5 5 5 6 1 0 0 0 0 0 0 0 0 1 7 23 24 24 25 9 1 0 
0 0 0 1 7 8 8 8 8 8 8 8 8 8 8 8 8 8 8 8 8 8 8 8 8 8 8 8 8 8 8 9 1 0 0 1 1 1 1 1 1 1 7 23 24 24 25 9 1 0 
0 0 0 1 7 8 8 8 8 20 21 21 21 21 21 21 21 21 21 21 21 21 21 21 22 8 8 8 8 8 8 9 1 0 0 1 4 5 5 5 5 5 13 23 24 24 25 9 1 0 
0 0 0 1 7 8 8 8 8 23 24 24 24 24 24 24 24 24 24 24 24 24 24 24 25 8 8 8 8 8 8 9 1 0 0 1 7 8 8 8 8 8 8 23 29 27 28 9 1 0 
0 0 0 1 7 8 8 8 8 23 24 24 24 24 24 24 24 24 24 24 24 24 24 24 25 8 8 8 8 8 8 9 1 0 0 1 7 20 21 21 21 21 21 32 25 16 11 12 1 0 
1 1 1 1 7 8 8 8 8 23 24 24 24 24 24 24 24 24 24 24 24 24 24 24 25 8 8 8 8 8 8 9 1 0 0 1 7 23 24 24 24 24 24 24 25 9 1 1 1 0 
2 2 2 2 7 8 8 8 8 23 24 24 24 24 24 24 24 24 24 24 24 24 24 24 25 8 8 8 8 8 8 9 1 1 1 1 7 23 24 24 24 24 24 24 25 9 1 0 0 0 
3 3 3 3 7 8 8 8 8 23 24 24 24 24 24 24 24 24 24 24 24 24 24 24 25 8 8 8 8 8 8 9 2 2 2 2 7 23 24 24 24 24 24 24 25 9 1 0 0 0 
5 5 5 5 13 8 8 8 8 23 24 24 24 24 24 24 24 24 24 24 24 24 24 24 31 21 21 22 8 8 8 9 3 3 3 3 7 23 24 24 24 24 24 24 25 9 1 1 1 1 
1 1 1 1 15 8 8 8 8 23 24 24 24 24 24 24 24 24 24 24 24 24 24 24 29 27 27 28 8 8 8 14 5 5 5 5 13 23 24 24 24 24 24 24 25 9 2 2 2 2 
2 2 2 1 7 8 8 8 8 23 24 24 24 24 24 24 24 24 24 24 24 24 24 24 25 8 8 8 8 8 8 16 1 1 1 1 15 23 24 24 24 24 24 24 25 9 3 3 3 3 
3 3 3 1 7 8 8 8 8 23 24 24 24 24 24 24 24 24 24 24 24 24 24 24 25 8 8 8 8 8 8 9 1 2 2 1 7 23 24 24 24 24 24 24 25 14 5 5 5 5 
0 0 0 1 7 8 8 8 8 23 24 24 24 24 24 24 24 24 24 24 24 24 24 24 25 8 8 8 8 8 8 9 1 3 3 1 7 23 24 24 24 24 24 24 25 16 1 1 1 1 
0 0 0 1 7 8 8 8 8 26 27 27 27 27 27 27 27 27 27 27 27 27 27 27 28 8 8 8 8 8 8 9 1 0 0 1 7 23 24 24 24 24 24 24 25 9 1 2 2 2 
0 0 0 1 7 8 8 8 8 8 8 8 8 8 8 8 8 8 8 8 8 8 8 8 8 8 8 8 8 8 8 9 1 0 0 1 7 26 27 27 27 27 27 27 28 9 1 3 3 3 
0 0 0 1 7 8 8 8 8 8 8 8 8 8 8 8 8 8 8 8 8 8 8 8 8 8 8 8 8 8 8 9 1 0 0 1 7 8 8 8 8 8 8 8 8 9 1 0 0 0 
0 0 0 1 7 8 8 8 8 8 8 8 8 8 8 8 8 8 8 8 8 8 8 8 8 8 8 8 8 8 8 9 1 0 0 1 7 8 8 8 8 8 8 8 8 9 1 0 0 0 
0 0 0 1 7 8 8 8 8 8 8 8 8 8 8 8 8 8 8 8 8 8 8 8 8 8 8 8 8 8 8 9 1 0 0 1 7 8 8 8 8 8 8 8 8 9 1 0 0 0 
0 0 0 1 1 1 1 1 1 1 1 1 1 1 1 1 1 1 1 1 1 1 1 1 1 1 1 1 1 1 1 1 1 0 0 1 7 8 8 8 8 8 8 8 8 9 1 0 0 0 
0 0 0 2 2 2 2 2 2 2 2 2 2 2 2 2 2 2 2 2 2 2 2 2 2 2 2 2 2 2 2 2 2 0 0 1 7 8 8 8 8 8 8 8 8 9 1 0 0 0 
0 0 0 3 3 3 3 3 3 3 3 3 3 3 3 3 3 3 3 3 3 3 3 3 3 3 3 3 3 3 3 3 3 0 0 1 7 8 8 8 8 8 8 8 8 9 1 0 0 0 
0 0 0 0 0 0 0 0 0 0 0 0 0 0 0 0 0 0 0 0 0 0 0 0 0 0 0 0 0 0 0 0 0 0 0 1 7 8 8 8 8 8 8 8 8 9 1 0 0 0 
0 0 0 0 0 0 0 0 0 0 0 0 0 0 0 0 0 0 0 0 0 0 0 0 0 0 0 0 0 0 0 0 0 0 0 1 7 8 8 8 8 8 8 8 8 9 1 0 0 0 
0 0 0 0 0 0 0 0 0 0 0 0 0 0 0 0 0 0 0 0 0 0 0 0 0 0 0 0 0 0 0 0 0 0 0 1 7 8 8 8 8 8 8 8 8 9 1 0 0 0 
0 0 0 1 1 1 1 1 1 1 1 1 1 1 1 1 1 1 1 1 1 1 1 1 1 1 1 1 1 1 1 1 1 1 1 1 7 8 8 20 21 21 21 22 8 9 1 0 0 0 
0 0 0 1 2 2 2 2 2 2 2 2 2 2 2 2 2 2 2 2 2 2 2 2 2 2 2 2 2 2 2 2 2 2 2 2 7 8 8 23 24 24 24 25 8 9 1 0 0 0 
0 0 0 1 3 3 3 3 3 3 3 3 3 3 3 3 3 3 3 3 3 3 3 3 3 3 3 3 3 3 3 3 3 3 3 3 7 8 8 23 24 24 24 25 8 9 1 0 0 0 
0 0 0 1 4 5 5 5 5 5 5 5 5 5 5 5 5 5 5 5 5 5 5 5 5 5 5 5 5 5 5 5 5 5 5 5 13 8 8 23 24 24 24 25 8 9 1 0 0 0 
1 1 1 1 7 8 8 8 20 21 21 21 21 21 21 21 21 21 21 21 21 21 21 21 21 21 21 22 8 8 8 8 8 8 8 8 8 8 8 23 24 24 24 25 8 9 1 0 0 0 
2 2 2 2 7 8 8 8 23 24 24 24 24 24 24 24 24 24 24 24 24 24 24 24 24 24 24 25 8 8 8 8 8 8 8 8 8 8 8 23 24 24 24 25 8 9 1 0 0 0 
3 3 3 3 7 8 8 8 23 24 24 24 24 24 24 24 24 24 24 24 24 24 24 24 24 24 24 25 8 8 8 8 8 8 8 8 8 8 8 23 24 24 24 25 8 9 1 1 1 1 
5 5 5 5 13 8 8 8 23 24 24 24 24 24 24 24 24 24 24 24 24 24 24 24 24 24 24 25 8 8 8 8 8 8 8 8 8 8 8 23 24 24 24 25 8 9 2 2 2 2 
1 1 1 1 15 8 8 8 23 24 24 24 24 24 24 24 24 24 24 24 24 24 24 24 24 24 24 25 8 8 8 8 8 8 8 8 8 8 8 23 24 24 24 25 8 9 3 3 3 3 
2 2 2 1 7 8 8 8 23 24 24 24 24 24 24 24 24 24 24 24 29 27 27 27 27 27 27 28 8 8 8 8 8 8 8 8 8 8 8 23 24 24 24 25 8 14 5 5 5 5 
3 3 3 1 7 8 8 8 23 24 24 24 24 24 24 24 24 24 24 24 25 8 8 8 8 8 8 8 8 8 8 8 8 8 8 8 8 8 8 23 24 24 24 25 8 16 1 1 1 1 
0 0 0 1 7 8 8 8 23 24 24 24 24 24 24 24 24 24 24 24 25 8 8 8 1 1 1 1 1 1 1 1 1 1 1 1 1 1 15 23 24 24 24 25 8 9 1 2 2 2 
0 0 0 1 7 8 8 8 23 24 24 24 24 24 24 24 24 24 24 24 25 8 8 8 1 2 2 2 2 2 2 2 2 2 2 2 2 1 7 23 24 24 24 25 8 9 1 3 3 3 
0 0 0 1 7 8 8 8 26 27 27 27 27 27 27 30 24 29 27 27 28 8 8 8 1 3 3 3 3 3 3 3 3 3 3 3 3 1 7 23 24 24 24 25 8 9 1 0 0 0 
0 0 0 1 7 8 8 8 8 8 8 8 8 8 8 23 24 25 8 8 8 8 8 8 1 0 0 0 0 0 0 0 0 0 0 0 0 1 7 26 27 27 27 28 8 9 1 0 0 0 
0 0 0 1 1 1 1 1 1 1 1 1 1 1 1 26 27 28 1 1 1 1 1 1 1 0 0 0 0 0 0 0 0 0 0 0 0 1 7 8 8 8 8 8 8 9 1 0 0 0 
0 0 0 2 2 2 2 2 2 2 2 2 2 2 1 7 8 9 1 2 2 2 2 2 2 0 0 0 0 0 0 0 0 0 0 0 0 1 7 8 8 8 8 8 8 9 1 0 0 0 
0 0 0 3 3 3 3 3 3 3 3 3 3 3 1 7 8 9 1 3 3 3 3 3 3 0 0 0 0 0 0 0 0 0 0 0 0 1 1 1 1 1 1 1 1 1 1 0 0 0 
0 0 0 0 0 0 0 0 0 0 0 0 0 0 1 7 8 9 1 0 0 0 0 0 0 0 0 0 0 0 0 0 0 0 0 0 0 2 2 2 2 2 2 2 2 2 2 0 0 0 
