0 0 0 0 0 0 0 0 0 0 0 0 0 0 0 0 0 0 0 0 0 0 0 0 0 0 0 1 1 1 1 1 1 1 1 1 1 1 1 1 1 1 1 1 1 1 1 1 1 1 
0 0 0 0 0 0 0 0 0 0 0 0 0 0 25 25 0 0 0 0 0 0 0 0 0 0 0 1 1 1 1 1 1 1 1 1 1 1 1 1 1 1 1 1 1 1 1 1 1 1 
0 0 2 2 2 2 2 2 2 0 0 0 0 25 25 0 0 0 0 0 0 0 0 25 25 25 0 1 1 1 1 1 1 1 1 1 1 1 1 1 1 1 1 1 1 1 1 1 1 1 
0 2 2 2 2 2 21 2 2 0 0 27 27 27 27 27 27 27 27 27 27 27 21 27 27 25 0 1 1 1 1 1 1 1 1 1 1 1 1 1 1 1 1 1 1 1 1 1 1 1 
6 28 28 28 28 28 28 28 28 28 28 9 28 28 28 28 28 28 28 28 28 28 28 16 27 25 0 1 1 1 1 1 1 1 1 1 1 1 1 1 1 1 1 1 1 1 1 1 1 1 
0 2 2 2 2 2 2 2 2 25 25 27 27 27 27 2 2 2 2 2 2 28 28 2 27 0 0 1 1 1 1 1 1 1 1 1 1 1 1 1 1 1 1 1 1 1 1 1 1 1 
0 0 2 23 23 23 2 2 24 0 0 0 0 0 27 2 2 2 2 2 2 28 28 2 27 0 0 1 1 1 1 1 1 1 1 1 1 1 1 1 1 1 1 1 1 1 1 1 1 1 
0 0 0 0 0 25 25 25 25 0 0 0 0 0 27 27 27 27 27 27 2 28 28 2 27 0 0 1 1 1 1 1 1 1 1 1 1 1 1 1 1 1 1 1 1 1 1 1 1 1 
0 0 0 0 0 0 0 0 0 0 0 0 0 0 0 0 0 0 0 27 2 28 28 2 27 0 0 1 1 1 1 1 1 1 1 1 1 1 1 1 1 1 1 1 1 1 1 1 1 1 
0 0 0 0 0 0 0 0 0 0 0 0 0 0 0 0 0 0 0 27 2 28 28 2 27 0 0 1 1 1 1 1 1 1 1 1 1 1 1 1 1 1 1 1 1 1 1 1 1 1 
1 1 0 0 0 0 0 0 0 0 1 1 1 1 1 1 1 0 0 27 2 28 28 2 27 25 0 1 1 1 1 1 1 1 1 1 1 1 1 1 1 1 1 1 1 1 1 1 1 1 
1 1 1 0 0 0 1 1 1 1 1 1 1 1 1 1 1 0 0 27 2 28 28 9 27 25 0 1 1 1 1 1 1 1 1 1 1 1 1 1 1 1 1 1 1 1 1 1 1 1 
1 1 1 0 0 0 1 1 1 1 1 1 1 1 1 1 1 0 0 27 2 28 28 2 27 25 25 0 1 1 1 1 1 1 1 1 1 1 1 1 1 1 1 1 1 1 1 1 1 1 
1 1 1 0 0 0 1 1 1 1 1 1 1 1 1 1 1 0 0 27 27 28 28 27 27 0 25 25 1 1 1 1 1 1 1 1 1 1 1 1 1 1 1 1 1 1 1 1 1 1 
1 1 1 1 1 1 1 1 1 1 1 1 1 1 1 1 1 25 0 0 25 28 28 0 0 0 0 1 1 1 1 1 1 1 1 1 1 1 1 1 1 1 1 1 1 1 1 1 1 1 
1 1 1 1 1 1 1 1 1 1 0 0 0 0 0 0 0 25 25 0 25 28 28 0 0 0 0 1 1 1 1 1 1 1 1 1 1 1 1 1 1 1 1 1 1 1 1 1 1 1 
1 1 1 1 1 1 25 25 0 0 0 27 27 27 27 25 0 0 25 25 25 28 28 0 0 0 0 1 1 1 1 1 1 1 1 25 25 25 25 25 6 7 25 25 25 1 1 1 1 1 
1 1 1 1 1 1 25 26 26 26 2 2 3 2 27 25 0 0 0 0 0 28 28 0 0 0 0 0 0 0 0 0 0 0 0 25 25 5 2 2 28 2 2 29 25 1 1 1 1 1 
1 1 1 1 1 1 25 26 28 28 28 28 28 9 27 25 24 26 2 2 2 27 9 2 22 26 11 24 11 26 11 26 11 26 11 25 0 28 28 28 28 2 10 2 25 1 1 1 1 1 
1 1 1 1 1 1 25 26 28 0 0 27 27 27 27 25 26 26 27 27 27 27 2 2 26 11 22 11 26 11 26 11 26 11 26 25 25 2 2 2 28 28 28 28 25 1 1 1 1 1 
1 1 1 1 1 1 25 26 28 0 0 0 0 0 0 25 26 26 27 27 27 27 2 0 0 0 0 0 0 0 0 0 0 0 0 0 25 24 2 19 19 19 2 28 25 1 1 1 1 1 
1 1 1 1 1 1 25 26 28 0 0 0 0 0 0 0 26 26 10 2 2 27 2 0 1 1 1 1 1 1 1 1 1 1 1 1 25 25 25 25 25 0 0 28 25 1 1 1 1 1 
1 1 1 1 1 1 0 2 28 0 0 0 0 0 0 0 0 0 0 0 0 0 28 0 1 1 1 1 1 1 1 1 1 1 1 1 25 25 25 25 25 6 8 28 25 1 1 1 1 1 
1 1 1 1 1 1 0 24 28 0 0 0 0 0 0 0 18 27 27 25 25 0 28 25 1 1 1 1 1 1 1 1 1 1 1 1 25 27 27 27 29 28 2 28 25 1 1 1 1 1 
1 1 1 1 1 1 0 2 28 0 0 0 0 25 25 0 0 0 27 0 25 25 28 25 1 1 1 1 1 1 1 1 1 1 1 1 25 27 3 27 28 28 28 28 25 1 1 1 1 1 
1 1 1 1 1 1 0 2 28 0 25 25 25 25 0 0 0 0 27 0 0 0 28 25 1 1 1 1 1 1 1 1 1 1 1 1 25 27 27 27 28 2 2 10 25 1 1 1 1 1 
1 1 1 1 1 1 0 2 28 2 2 2 24 2 2 2 0 27 28 28 28 28 28 0 1 1 1 1 1 1 1 1 1 1 1 1 25 28 28 28 28 26 23 26 25 1 1 1 1 1 
1 1 1 1 1 1 0 2 28 28 28 28 28 28 2 2 0 12 28 2 23 2 0 0 1 1 1 1 1 1 1 1 1 1 1 1 25 25 25 25 25 25 25 25 25 1 1 1 1 1 
1 1 1 1 1 1 0 2 2 2 23 2 2 28 2 2 0 2 28 12 24 2 0 0 1 1 1 1 1 1 1 1 1 1 1 1 1 1 1 1 1 1 1 1 1 1 1 1 1 1 
1 1 1 1 1 1 0 25 25 25 2 2 2 28 28 28 28 28 28 23 2 12 0 0 1 1 1 1 1 1 1 1 1 1 1 1 1 1 1 1 1 1 1 1 1 1 1 1 1 1 
1 1 1 1 1 1 1 1 1 25 2 2 2 2 2 2 0 0 0 0 0 0 0 0 1 1 1 1 1 1 1 1 1 1 1 1 1 1 1 1 1 1 1 1 1 1 1 1 1 1 
1 1 1 1 1 1 1 1 1 25 25 25 25 25 25 25 0 0 0 0 0 0 0 0 1 1 1 1 1 1 1 1 1 1 1 1 1 1 1 1 1 1 1 1 1 1 1 1 1 1 
1 1 1 1 1 1 1 1 1 1 1 1 1 1 1 1 1 1 1 1 1 1 1 1 1 1 1 1 1 1 1 1 1 1 1 1 1 1 1 1 1 1 1 1 1 1 1 1 1 1 
1 1 1 1 1 1 1 1 1 1 1 1 1 1 1 1 1 1 1 1 1 1 1 1 1 1 1 1 1 1 1 1 1 1 1 1 1 1 1 1 1 1 1 1 1 1 1 1 1 1 
1 1 1 1 1 1 1 1 1 1 1 1 1 1 1 1 1 1 1 1 1 1 1 1 1 1 1 1 1 1 1 1 1 1 1 1 1 1 1 1 1 1 1 1 1 1 1 1 1 1 
1 1 1 1 1 1 1 1 1 1 1 1 1 1 1 1 1 1 1 1 1 1 1 1 1 1 1 1 1 1 1 1 1 1 1 1 1 1 1 1 1 1 1 1 1 1 1 1 1 1 
1 1 1 1 1 1 1 1 1 1 1 1 1 1 1 1 1 1 1 1 1 1 1 1 1 1 1 1 1 1 1 1 1 1 1 1 1 1 1 1 1 1 1 1 1 1 1 1 1 1 
1 1 1 1 1 1 1 1 1 1 1 1 1 1 1 1 1 1 1 1 1 1 1 1 1 1 1 1 1 1 1 1 1 1 1 1 1 1 1 1 1 1 1 1 1 1 1 1 1 1 
1 1 1 1 1 1 1 1 1 1 1 1 1 1 1 1 1 1 1 1 1 1 1 1 1 1 1 1 1 1 1 1 1 1 1 1 1 1 1 1 1 1 1 1 1 1 1 1 1 1 
1 1 1 1 1 1 1 1 1 1 1 1 1 1 1 1 1 1 1 1 1 1 1 1 1 1 1 1 1 1 1 1 1 1 1 1 1 1 1 1 1 1 1 1 1 1 1 1 1 1 
1 1 1 1 1 1 1 1 1 1 1 1 1 1 1 1 1 1 1 1 1 1 1 1 1 1 1 1 1 1 1 1 1 1 1 1 1 1 1 1 1 1 1 1 1 1 1 1 1 1 
1 1 1 1 1 1 1 1 1 1 1 1 1 1 1 1 1 1 1 1 1 1 1 1 1 1 1 1 1 1 1 1 1 1 1 1 1 1 1 1 1 1 1 1 1 1 1 1 1 1 
1 1 1 1 1 1 1 1 1 1 1 1 1 1 1 1 1 1 1 1 1 1 1 1 1 1 1 1 1 1 1 1 1 1 1 1 1 1 1 1 1 1 1 1 1 1 1 1 1 1 
1 1 1 1 1 1 1 1 1 1 1 1 1 1 1 1 1 1 1 1 1 1 1 1 1 1 1 1 1 1 1 1 1 1 1 1 1 1 1 1 1 1 1 1 1 1 1 1 1 1 
1 1 1 1 1 1 1 1 1 1 1 1 1 1 1 1 1 1 1 1 1 1 1 1 1 1 1 1 1 1 1 1 1 1 1 1 1 1 1 1 1 1 1 1 1 1 1 1 1 1 
1 1 1 1 1 1 1 1 1 1 1 1 1 1 1 1 1 1 1 1 1 1 1 1 1 1 1 1 1 1 1 1 1 1 1 1 1 1 1 1 1 1 1 1 1 1 1 1 1 1 
1 1 1 1 1 1 1 1 1 1 1 1 1 1 1 1 1 1 1 1 1 1 1 1 1 1 1 1 1 1 1 1 1 1 1 1 1 1 1 1 1 1 1 1 1 1 1 1 1 1 
1 1 1 1 1 1 1 1 1 1 1 1 1 1 1 1 1 1 1 1 1 1 1 1 1 1 1 1 1 1 1 1 1 1 1 1 1 1 1 1 1 1 1 1 1 1 1 1 1 1 
1 1 1 1 1 1 1 1 1 1 1 1 1 1 1 1 1 1 1 1 1 1 1 1 1 1 1 1 1 1 1 1 1 1 1 1 1 1 1 1 1 1 1 1 1 1 1 1 1 1 
1 1 1 1 1 1 1 1 1 1 1 1 1 1 1 1 1 1 1 1 1 1 1 1 1 1 1 1 1 1 1 1 1 1 1 1 1 1 1 1 1 1 1 1 1 1 1 1 1 1 
