0 0 0 0 0 0 0 0 0 0 0 0 0 0 0 0 0 0 0 0 0 0 0 0 0 0 0 1 1 1 1 1 1 1 1 1 1 1 1 1 1 1 1 1 1 1 1 1 1 1 
0 0 0 0 0 0 0 0 0 0 0 0 0 0 25 25 0 0 0 0 0 0 0 0 0 0 0 1 1 1 1 1 1 1 1 1 1 1 1 1 1 1 1 1 1 1 1 1 1 1 
0 0 2 2 2 2 2 2 2 0 0 0 0 25 25 0 0 0 0 0 0 0 0 25 25 25 0 1 1 1 1 1 1 1 1 1 1 1 1 1 1 1 1 1 1 1 1 1 1 1 
0 2 2 2 2 2 21 2 2 0 0 2 2 2 2 2 2 2 2 2 2 2 21 23 23 25 0 1 1 1 1 1 1 1 1 1 1 1 1 1 1 1 1 1 1 1 1 1 1 1 
6 2 2 2 2 2 2 2 2 2 2 9 2 2 2 2 2 2 2 2 2 2 2 23 23 25 0 1 1 1 1 1 1 1 1 1 1 1 1 1 1 1 1 1 1 1 1 1 1 1 
0 2 2 2 2 2 2 2 2 25 25 2 2 2 2 2 2 2 2 2 2 9 2 23 23 0 0 1 1 1 1 1 1 1 1 1 1 1 1 1 1 1 1 1 1 1 1 1 1 1 
0 0 2 23 23 23 2 2 24 0 0 0 0 0 2 2 2 2 2 2 2 2 2 23 23 0 0 1 1 1 1 1 1 1 1 1 1 1 1 1 1 1 1 1 1 1 1 1 1 1 
0 0 0 0 0 25 25 25 25 0 0 0 0 0 24 2 23 2 2 2 2 2 2 23 23 0 0 1 1 1 1 1 1 1 1 1 1 1 1 1 1 1 1 1 1 1 1 1 1 1 
0 0 0 0 0 0 0 0 0 0 0 0 0 0 0 0 0 0 0 2 2 2 23 23 2 0 0 1 1 1 1 1 1 1 1 1 1 1 1 1 1 1 1 1 1 1 1 1 1 1 
0 0 0 0 0 0 0 0 0 0 0 0 0 0 0 0 0 0 0 2 2 2 23 2 2 0 0 1 1 1 1 1 1 1 1 1 1 1 1 1 1 1 1 1 1 1 1 1 1 1 
1 1 0 0 0 0 0 0 0 0 1 1 1 1 1 1 1 0 0 2 2 2 2 2 2 25 0 1 1 1 1 1 1 1 1 1 1 1 1 1 1 1 1 1 1 1 1 1 1 1 
1 1 1 0 0 0 1 1 1 1 1 1 1 1 1 1 1 0 0 2 2 9 2 9 2 25 0 1 1 1 1 1 1 1 1 1 1 1 1 1 1 1 1 1 1 1 1 1 1 1 
1 1 1 0 0 0 1 1 1 1 1 1 1 1 1 1 1 0 0 2 2 2 2 2 2 25 25 0 1 1 1 1 1 1 1 1 1 1 1 1 1 1 1 1 1 1 1 1 1 1 
1 1 1 0 0 0 1 1 1 1 1 1 1 1 1 1 1 0 0 2 2 2 2 2 2 0 25 25 1 1 1 1 1 1 1 1 1 1 1 1 1 1 1 1 1 1 1 1 1 1 
1 1 1 1 1 1 1 1 1 1 1 1 1 1 1 1 1 25 0 0 25 2 2 0 0 0 0 1 1 1 1 1 1 1 1 1 1 1 1 1 1 1 1 1 1 1 1 1 1 1 
1 1 1 1 1 1 1 1 1 1 0 0 0 0 0 0 0 25 25 0 25 2 2 0 0 0 0 1 1 1 1 1 1 1 1 1 1 1 1 1 1 1 1 1 1 1 1 1 1 1 
1 1 1 1 1 1 25 25 0 0 0 2 2 2 2 25 0 0 25 25 25 2 2 0 0 0 0 1 1 1 1 1 1 1 1 25 25 25 25 25 6 7 25 25 25 1 1 1 1 1 
1 1 1 1 1 1 25 2 2 2 2 2 3 2 2 25 0 0 0 0 0 2 2 0 0 0 0 0 0 0 0 0 0 0 0 25 25 5 2 2 2 2 2 18 25 1 1 1 1 1 
1 1 1 1 1 1 25 2 23 2 2 2 2 9 2 25 24 2 2 2 2 2 9 2 22 2 11 22 11 2 11 2 11 22 11 25 0 2 2 2 2 2 10 2 25 1 1 1 1 1 
1 1 1 1 1 1 25 2 2 0 0 2 2 2 24 25 2 2 2 2 2 2 2 2 2 11 22 11 22 11 22 11 22 11 22 25 25 2 2 2 2 2 2 2 25 1 1 1 1 1 
1 1 1 1 1 1 25 2 2 0 0 0 0 0 0 25 2 2 2 2 2 2 2 0 0 0 0 0 0 0 0 0 0 0 0 0 25 24 2 19 19 19 2 2 25 1 1 1 1 1 
1 1 1 1 1 1 25 2 2 0 0 0 0 0 0 0 2 2 10 2 2 2 2 0 1 1 1 1 1 1 1 1 1 1 1 1 25 25 25 25 25 0 0 2 25 1 1 1 1 1 
1 1 1 1 1 1 0 2 2 0 0 0 0 0 0 0 0 0 0 0 0 0 2 0 1 1 1 1 1 1 1 1 1 1 1 1 25 25 25 25 25 25 25 2 25 1 1 1 1 1 
1 1 1 1 1 1 0 23 2 0 0 0 0 0 0 0 18 23 2 25 25 0 2 25 1 1 1 1 1 1 1 1 1 1 1 1 25 2 2 2 2 2 2 2 25 1 1 1 1 1 
1 1 1 1 1 1 0 2 2 0 0 0 0 25 25 0 0 0 2 0 25 25 23 25 1 1 1 1 1 1 1 1 1 1 1 1 25 2 3 2 2 2 2 2 25 1 1 1 1 1 
1 1 1 1 1 1 0 2 2 0 25 25 25 25 0 0 0 0 2 0 0 0 2 25 1 1 1 1 1 1 1 1 1 1 1 1 25 2 2 2 2 2 2 10 25 1 1 1 1 1 
1 1 1 1 1 1 0 2 2 2 2 2 24 2 2 2 0 2 2 2 2 2 2 0 1 1 1 1 1 1 1 1 1 1 1 1 25 2 2 2 2 2 2 2 25 1 1 1 1 1 
1 1 1 1 1 1 0 2 2 2 2 2 2 2 2 2 0 12 2 2 23 2 0 0 1 1 1 1 1 1 1 1 1 1 1 1 25 25 25 25 25 25 25 25 25 1 1 1 1 1 
1 1 1 1 1 1 0 2 2 2 23 2 2 2 2 2 0 2 2 12 24 2 0 0 1 1 1 1 1 1 1 1 1 1 1 1 1 1 1 1 1 1 1 1 1 1 1 1 1 1 
1 1 1 1 1 1 0 25 25 25 2 2 2 2 2 2 2 2 2 23 2 12 0 0 1 1 1 1 1 1 1 1 1 1 1 1 1 1 1 1 1 1 1 1 1 1 1 1 1 1 
1 1 1 1 1 1 1 1 1 25 2 2 2 2 2 2 0 0 0 0 0 0 0 0 1 1 1 1 1 1 1 1 1 1 1 1 1 1 1 1 1 1 1 1 1 1 1 1 1 1 
1 1 1 1 1 1 1 1 1 25 25 25 25 25 25 25 0 0 0 0 0 0 0 0 1 1 1 1 1 1 1 1 1 1 1 1 1 1 1 1 1 1 1 1 1 1 1 1 1 1 
1 1 1 1 1 1 1 1 1 1 1 1 1 1 1 1 1 1 1 1 1 1 1 1 1 1 1 1 1 1 1 1 1 1 1 1 1 1 1 1 1 1 1 1 1 1 1 1 1 1 
1 1 1 1 1 1 1 1 1 1 1 1 1 1 1 1 1 1 1 1 1 1 1 1 1 1 1 1 1 1 1 1 1 1 1 1 1 1 1 1 1 1 1 1 1 1 1 1 1 1 
1 1 1 1 1 1 1 1 1 1 1 1 1 1 1 1 1 1 1 1 1 1 1 1 1 1 1 1 1 1 1 1 1 1 1 1 1 1 1 1 1 1 1 1 1 1 1 1 1 1 
1 1 1 1 1 1 1 1 1 1 1 1 1 1 1 1 1 1 1 1 1 1 1 1 1 1 1 1 1 1 1 1 1 1 1 1 1 1 1 1 1 1 1 1 1 1 1 1 1 1 
1 1 1 1 1 1 1 1 1 1 1 1 1 1 1 1 1 1 1 1 1 1 1 1 1 1 1 1 1 1 1 1 1 1 1 1 1 1 1 1 1 1 1 1 1 1 1 1 1 1 
1 1 1 1 1 1 1 1 1 1 1 1 1 1 1 1 1 1 1 1 1 1 1 1 1 1 1 1 1 1 1 1 1 1 1 1 1 1 1 1 1 1 1 1 1 1 1 1 1 1 
1 1 1 1 1 1 1 1 1 1 1 1 1 1 1 1 1 1 1 1 1 1 1 1 1 1 1 1 1 1 1 1 1 1 1 1 1 1 1 1 1 1 1 1 1 1 1 1 1 1 
1 1 1 1 1 1 1 1 1 1 1 1 1 1 1 1 1 1 1 1 1 1 1 1 1 1 1 1 1 1 1 1 1 1 1 1 1 1 1 1 1 1 1 1 1 1 1 1 1 1 
1 1 1 1 1 1 1 1 1 1 1 1 1 1 1 1 1 1 1 1 1 1 1 1 1 1 1 1 1 1 1 1 1 1 1 1 1 1 1 1 1 1 1 1 1 1 1 1 1 1 
1 1 1 1 1 1 1 1 1 1 1 1 1 1 1 1 1 1 1 1 1 1 1 1 1 1 1 1 1 1 1 1 1 1 1 1 1 1 1 1 1 1 1 1 1 1 1 1 1 1 
1 1 1 1 1 1 1 1 1 1 1 1 1 1 1 1 1 1 1 1 1 1 1 1 1 1 1 1 1 1 1 1 1 1 1 1 1 1 1 1 1 1 1 1 1 1 1 1 1 1 
1 1 1 1 1 1 1 1 1 1 1 1 1 1 1 1 1 1 1 1 1 1 1 1 1 1 1 1 1 1 1 1 1 1 1 1 1 1 1 1 1 1 1 1 1 1 1 1 1 1 
1 1 1 1 1 1 1 1 1 1 1 1 1 1 1 1 1 1 1 1 1 1 1 1 1 1 1 1 1 1 1 1 1 1 1 1 1 1 1 1 1 1 1 1 1 1 1 1 1 1 
1 1 1 1 1 1 1 1 1 1 1 1 1 1 1 1 1 1 1 1 1 1 1 1 1 1 1 1 1 1 1 1 1 1 1 1 1 1 1 1 1 1 1 1 1 1 1 1 1 1 
1 1 1 1 1 1 1 1 1 1 1 1 1 1 1 1 1 1 1 1 1 1 1 1 1 1 1 1 1 1 1 1 1 1 1 1 1 1 1 1 1 1 1 1 1 1 1 1 1 1 
1 1 1 1 1 1 1 1 1 1 1 1 1 1 1 1 1 1 1 1 1 1 1 1 1 1 1 1 1 1 1 1 1 1 1 1 1 1 1 1 1 1 1 1 1 1 1 1 1 1 
1 1 1 1 1 1 1 1 1 1 1 1 1 1 1 1 1 1 1 1 1 1 1 1 1 1 1 1 1 1 1 1 1 1 1 1 1 1 1 1 1 1 1 1 1 1 1 1 1 1 
1 1 1 1 1 1 1 1 1 1 1 1 1 1 1 1 1 1 1 1 1 1 1 1 1 1 1 1 1 1 1 1 1 1 1 1 1 1 1 1 1 1 1 1 1 1 1 1 1 1 
