1 1 1 1 1 1 1 1 1 1 1 1 1 1 1 1 1 1 1 1 1 1 1 1 1 1 1 1 1 1 1 1 1 1 1 1 1 1 1 1 1 1 1 1 1 1 1 1 1 1 
1 0 0 0 0 0 0 0 0 0 0 0 0 0 0 0 0 0 0 0 0 0 0 0 0 0 0 0 0 0 0 0 0 0 0 0 0 1 1 1 1 1 1 1 1 1 1 1 1 1 
1 0 2 2 2 2 2 2 2 2 2 2 2 2 2 2 2 2 2 2 2 2 2 2 2 2 2 2 2 2 2 2 2 2 2 2 0 1 1 1 1 1 1 1 1 1 1 1 1 1 
1 0 2 2 2 2 2 2 2 2 2 2 2 4 4 4 4 2 2 25 25 25 2 2 2 2 2 2 11 2 2 2 2 2 2 2 0 1 1 1 1 1 1 1 1 1 1 1 1 1 
1 0 2 2 2 2 2 2 2 2 2 2 2 2 2 2 2 2 2 25 25 25 2 2 2 2 2 2 2 2 2 2 2 2 2 2 0 0 25 25 25 25 25 25 25 25 0 0 1 1 
1 0 2 2 2 0 0 2 2 25 0 2 2 2 2 2 2 2 2 0 25 25 2 2 2 2 2 0 0 0 0 2 2 2 2 2 23 23 23 23 23 23 23 23 2 2 2 0 1 1 
1 0 2 2 2 25 25 2 2 0 25 2 2 9 2 2 2 2 2 0 25 25 2 2 2 2 0 0 1 1 0 2 2 2 2 2 23 23 23 23 2 23 2 2 2 2 2 25 1 1 
1 0 20 2 2 2 2 2 23 2 2 2 2 2 2 9 2 2 2 2 2 2 2 2 22 2 0 1 1 1 0 2 2 2 2 2 2 2 2 2 2 2 2 2 2 2 2 25 1 1 
1 0 2 2 2 0 25 2 23 25 25 2 2 9 2 19 2 9 2 0 0 0 2 2 2 2 0 1 1 1 0 2 2 2 2 2 2 2 2 2 2 2 2 2 2 2 19 25 1 1 
1 0 2 2 2 0 0 2 23 25 25 2 2 2 2 2 2 2 2 2 2 2 2 2 2 2 0 1 1 1 0 2 2 2 2 2 2 2 2 12 2 2 2 2 2 2 19 25 1 1 
1 0 2 2 2 2 2 2 2 2 2 2 2 2 2 9 2 2 2 2 2 22 2 2 2 2 0 1 1 1 0 2 2 2 2 2 2 23 2 2 2 2 2 2 2 10 19 25 1 1 
1 0 2 22 2 2 24 2 2 2 2 2 2 2 2 2 2 2 2 2 2 2 2 2 2 0 1 1 1 1 0 2 2 2 2 2 2 2 2 2 2 2 2 2 2 2 4 0 1 1 
1 0 0 0 0 0 0 0 0 25 25 25 25 25 25 25 25 25 25 25 25 25 25 0 0 0 1 1 1 1 0 2 2 2 2 2 2 2 2 2 0 0 0 2 2 4 4 0 1 1 
1 1 1 1 1 1 1 1 1 1 1 1 1 1 1 1 1 1 1 1 1 1 1 1 1 1 1 1 1 1 0 2 2 2 2 2 2 2 2 2 0 1 0 4 4 4 4 0 1 1 
1 1 1 1 1 1 1 1 1 1 1 1 1 1 1 1 1 1 1 1 1 1 1 1 1 1 1 1 1 1 0 2 2 2 2 2 2 2 2 2 0 1 0 0 0 0 0 0 1 1 
1 1 1 1 1 1 1 1 1 1 1 1 1 1 1 1 1 1 1 1 1 1 1 1 1 1 1 1 1 1 0 2 2 2 2 0 0 0 23 2 25 1 1 1 1 1 1 1 1 1 
1 1 1 1 1 1 1 1 1 1 1 1 1 1 1 1 1 1 1 1 1 1 1 1 1 1 1 1 1 1 0 2 2 2 2 0 1 0 2 9 25 1 1 1 1 1 1 1 1 1 
1 1 1 1 1 1 1 1 1 1 1 1 1 1 1 1 1 1 1 1 1 1 1 1 1 1 1 1 1 1 0 2 2 23 2 0 1 0 0 25 25 1 1 1 1 1 1 1 1 1 
1 1 1 1 1 1 1 1 1 1 1 1 1 1 1 1 1 1 1 1 1 1 1 1 1 1 1 1 1 1 0 2 23 23 2 0 1 1 1 1 1 1 1 1 1 1 1 1 1 1 
1 1 1 1 1 1 1 1 1 1 1 1 1 1 1 1 1 1 1 1 1 1 1 1 1 1 1 1 1 1 0 2 23 2 2 0 1 1 1 1 1 1 1 1 1 1 1 1 1 1 
1 1 1 1 1 1 1 1 1 1 1 1 1 1 1 1 1 1 1 1 1 1 1 1 1 1 1 1 1 1 0 2 2 2 2 0 1 1 1 1 1 1 1 1 0 0 0 0 0 1 
1 1 1 1 1 1 1 1 1 1 1 1 1 1 1 1 1 1 1 1 1 1 1 1 1 1 1 1 1 1 0 2 2 24 2 0 1 1 1 1 1 1 1 0 0 10 4 10 0 1 
1 1 1 1 1 1 1 1 1 1 1 1 1 1 1 1 1 1 1 1 1 1 1 1 1 1 1 1 1 1 0 2 2 2 2 0 1 1 1 1 1 1 1 0 2 2 2 2 0 1 
1 1 1 1 1 1 1 1 1 1 1 1 1 1 1 1 1 1 1 1 1 1 1 1 1 1 1 1 1 1 0 2 2 2 2 0 0 1 1 1 1 1 1 0 2 2 2 2 0 1 
1 1 1 1 1 1 1 1 1 1 1 1 1 1 1 1 0 0 0 0 0 0 0 0 0 0 0 0 0 0 0 2 2 2 2 2 0 1 1 1 1 1 1 25 2 2 2 2 0 1 
1 1 1 1 1 1 1 1 1 1 1 1 1 1 1 1 0 2 18 0 2 2 2 2 2 2 2 11 2 2 2 2 2 2 2 2 25 25 25 25 25 25 25 25 2 2 2 2 0 1 
1 1 1 1 1 1 1 1 1 1 1 0 0 0 0 0 0 2 2 0 2 2 2 2 2 2 2 11 2 2 2 2 2 2 2 2 2 2 2 2 2 24 24 2 2 2 2 2 0 1 
1 1 1 1 1 1 1 1 1 1 1 0 4 4 2 2 11 2 0 0 2 0 0 0 0 0 0 0 0 0 0 2 2 2 2 2 2 2 2 2 2 2 2 2 2 2 2 2 0 1 
1 1 1 1 1 1 1 1 1 1 1 0 4 4 2 2 0 2 2 2 2 0 1 1 1 1 1 1 1 1 0 0 0 2 2 2 2 2 4 4 2 2 2 2 2 2 2 2 0 1 
1 1 1 1 1 1 1 1 1 1 1 0 4 2 2 2 0 0 0 0 12 0 1 0 0 0 0 0 0 1 1 0 0 2 2 2 2 2 4 4 2 2 2 2 2 2 2 2 0 1 
1 1 1 1 1 1 1 1 1 1 1 0 4 2 2 2 2 2 2 0 0 0 1 0 18 2 2 2 0 0 0 0 0 2 2 2 2 2 2 2 2 2 25 25 0 0 2 2 0 1 
1 1 1 1 1 1 1 1 1 1 1 0 19 2 2 2 2 2 2 23 19 0 1 0 19 2 2 2 2 2 2 2 2 2 2 2 2 2 2 2 2 2 25 1 1 0 2 2 0 1 
1 1 1 1 1 1 1 1 1 1 1 0 19 2 2 2 2 2 2 22 24 0 1 0 19 2 2 2 2 2 2 2 2 2 2 25 6 25 2 2 2 2 25 1 1 0 2 2 0 1 
1 1 1 1 0 0 0 0 0 1 1 0 2 2 2 2 2 2 2 22 22 0 1 0 19 12 12 12 12 0 25 25 25 25 25 25 2 25 25 2 2 2 0 1 1 0 9 9 0 1 
1 1 1 1 0 5 2 2 0 1 1 0 2 2 2 2 2 2 0 0 0 0 1 0 0 0 0 0 0 0 19 19 19 19 19 19 2 18 25 25 2 2 0 1 1 0 19 19 0 1 
1 1 1 1 0 2 2 2 0 1 0 0 2 2 2 2 2 2 0 1 1 1 1 1 1 1 1 1 1 25 14 14 14 18 18 2 2 18 25 25 25 25 0 1 1 0 0 0 0 1 
0 0 0 0 0 2 2 9 0 0 0 2 2 11 2 2 2 2 0 1 1 1 1 1 1 1 1 1 1 25 25 25 25 25 25 25 25 25 25 25 25 25 1 1 1 1 1 1 1 1 
0 10 9 2 2 2 2 2 2 2 2 2 2 2 2 2 2 2 0 1 1 1 1 1 1 1 1 1 1 1 1 1 1 1 1 1 1 1 1 1 1 1 1 1 1 1 1 1 1 1 
0 10 11 2 2 2 2 2 2 2 10 2 2 2 2 2 4 4 0 1 1 1 1 1 1 1 1 1 1 1 1 1 1 1 1 1 1 1 1 1 1 1 1 1 1 1 1 1 1 1 
0 2 2 2 0 0 0 2 2 2 2 2 2 2 0 0 0 0 0 1 1 1 1 1 1 1 1 1 1 1 1 1 1 1 1 1 1 1 1 1 1 1 1 1 1 1 1 1 1 1 
0 2 2 2 0 0 0 2 2 2 2 2 2 2 0 1 1 1 1 1 1 1 1 1 1 1 1 1 1 1 1 1 1 1 1 1 1 1 1 1 1 1 1 1 1 1 1 1 1 1 
0 2 2 2 0 0 0 2 2 11 2 2 2 2 0 1 1 1 1 1 1 1 1 1 1 1 1 1 1 1 1 1 1 1 1 1 1 1 1 1 1 1 1 1 1 1 1 1 1 1 
0 9 2 0 0 0 2 2 2 0 0 0 2 2 0 1 1 1 1 1 1 1 1 1 1 1 1 1 1 1 1 1 1 1 1 1 1 1 1 1 1 1 1 1 1 1 1 1 1 1 
0 2 2 0 0 0 2 2 2 0 0 0 2 2 0 1 1 1 1 1 1 1 1 1 1 1 1 1 1 1 1 1 1 1 1 1 1 1 1 1 1 1 1 1 1 1 1 1 1 1 
0 2 2 6 8 0 9 2 2 0 0 0 2 2 0 1 1 1 1 1 1 1 1 1 1 1 1 1 1 1 1 1 1 1 1 1 1 1 1 1 1 1 1 1 1 1 1 1 1 1 
0 2 2 2 2 2 2 2 0 0 0 2 2 11 0 1 1 1 1 1 1 1 1 1 1 1 1 1 1 1 1 1 1 1 1 1 1 1 1 1 1 1 1 1 1 1 1 1 1 1 
0 2 11 2 2 2 2 2 0 0 0 2 2 4 0 1 1 1 1 1 1 1 1 1 1 1 1 1 1 1 1 1 1 1 1 1 1 1 1 1 1 1 1 1 1 1 1 1 1 1 
0 2 2 2 2 2 2 2 6 7 0 2 2 4 0 1 1 1 1 1 1 1 1 1 1 1 1 1 1 1 1 1 1 1 1 1 1 1 1 1 1 1 1 1 1 1 1 1 1 1 
0 19 19 11 2 2 2 2 2 2 9 2 4 4 0 1 1 1 1 1 1 1 1 1 1 1 1 1 1 1 1 1 1 1 1 1 1 1 1 1 1 1 1 1 1 1 1 1 1 1 
0 0 0 0 0 0 0 0 0 0 0 0 0 0 0 1 1 1 1 1 1 1 1 1 1 1 1 1 1 1 1 1 1 1 1 1 1 1 1 1 1 1 1 1 1 1 1 1 1 1 
