1 1 1 1 1 1 1 1 1 1 1 1 1 1 1 1 1 1 1 1 1 1 1 1 1 1 1 1 1 1 1 1 1 1 1 1 1 1 1 1 1 1 1 1 1 1 1 1 1 1 
1 0 0 0 0 0 0 0 0 0 0 0 0 0 0 0 0 0 0 0 0 0 0 0 0 0 0 0 0 0 0 0 0 0 0 0 0 1 1 1 1 1 1 1 1 1 1 1 1 1 
1 0 2 2 2 2 2 2 2 2 2 2 2 2 2 2 2 2 2 2 2 2 2 2 2 2 2 2 2 2 2 2 2 2 2 2 0 1 1 1 1 1 1 1 1 1 1 1 1 1 
1 0 2 2 2 2 2 2 2 2 2 2 2 4 4 4 4 2 2 0 0 0 2 2 2 2 2 2 11 2 2 2 2 2 2 2 0 1 1 1 1 1 1 1 1 1 1 1 1 1 
1 0 2 2 2 2 2 2 2 2 2 2 2 2 2 2 2 2 2 0 0 0 2 2 2 2 2 2 2 2 2 2 2 2 2 2 0 0 0 0 0 0 0 0 0 0 0 0 1 1 
1 0 2 2 2 0 0 2 2 0 0 2 2 2 2 2 2 2 2 0 0 0 2 2 2 2 2 0 0 0 0 2 2 2 2 2 2 2 2 2 2 2 2 2 2 2 2 0 1 1 
1 0 2 2 2 0 0 2 2 0 0 2 2 9 2 2 2 2 2 0 0 0 2 2 2 2 0 0 1 1 0 2 2 2 2 2 2 2 2 2 2 2 2 2 2 2 2 0 1 1 
1 0 2 5 2 2 2 2 2 2 2 2 2 2 2 9 2 2 2 2 2 2 2 2 2 2 0 1 1 1 0 2 2 2 2 2 2 2 2 2 2 2 2 2 2 2 2 0 1 1 
1 0 2 2 2 0 0 2 2 0 0 2 2 9 2 19 2 9 2 0 0 0 2 2 2 2 0 1 1 1 0 2 2 2 2 2 2 2 2 2 2 2 2 2 2 2 2 0 1 1 
1 0 2 2 2 0 0 2 2 0 0 2 2 2 2 2 2 2 2 2 2 2 2 2 2 2 0 1 1 1 0 2 2 2 2 2 2 2 2 12 2 2 2 2 2 2 2 0 1 1 
1 0 2 2 2 2 2 2 2 2 2 2 2 2 2 9 2 2 2 2 2 2 2 2 2 2 0 1 1 1 0 2 2 2 2 2 2 2 2 2 2 2 2 2 2 10 2 0 1 1 
1 0 2 2 2 2 2 2 2 2 2 2 2 2 2 2 2 2 2 2 2 2 2 2 2 0 1 1 1 1 0 2 2 2 2 2 2 2 2 2 2 2 2 2 2 2 4 0 1 1 
1 0 0 0 0 0 0 0 0 0 0 0 0 0 0 0 0 0 0 0 0 0 0 0 0 0 1 1 1 1 0 2 2 2 2 2 2 2 2 2 0 0 0 2 2 4 4 0 1 1 
1 1 1 1 1 1 1 1 1 1 1 1 1 1 1 1 1 1 1 1 1 1 1 1 1 1 1 1 1 1 0 2 2 2 2 2 2 2 2 2 0 1 0 4 4 4 4 0 1 1 
1 1 1 1 1 1 1 1 1 1 1 1 1 1 1 1 1 1 1 1 1 1 1 1 1 1 1 1 1 1 0 2 2 2 2 2 2 2 2 2 0 1 0 0 0 0 0 0 1 1 
1 1 1 1 1 1 1 1 1 1 1 1 1 1 1 1 1 1 1 1 1 1 1 1 1 1 1 1 1 1 0 2 2 2 2 0 0 0 2 2 0 1 1 1 1 1 1 1 1 1 
1 1 1 1 1 1 1 1 1 1 1 1 1 1 1 1 1 1 1 1 1 1 1 1 1 1 1 1 1 1 0 2 2 2 2 0 1 0 2 9 0 1 1 1 1 1 1 1 1 1 
1 1 1 1 1 1 1 1 1 1 1 1 1 1 1 1 1 1 1 1 1 1 1 1 1 1 1 1 1 1 0 2 2 2 2 0 1 0 0 0 0 1 1 1 1 1 1 1 1 1 
1 1 1 1 1 1 1 1 1 1 1 1 1 1 1 1 1 1 1 1 1 1 1 1 1 1 1 1 1 1 0 2 2 2 2 0 1 1 1 1 1 1 1 1 1 1 1 1 1 1 
1 1 1 1 1 1 1 1 1 1 1 1 1 1 1 1 1 1 1 1 1 1 1 1 1 1 1 1 1 1 0 2 2 2 2 0 1 1 1 1 1 1 1 1 1 1 1 1 1 1 
1 1 1 1 1 1 1 1 1 1 1 1 1 1 1 1 1 1 1 1 1 1 1 1 1 1 1 1 1 1 0 2 2 2 2 0 1 1 1 1 1 1 1 1 0 0 0 0 0 1 
1 1 1 1 1 1 1 1 1 1 1 1 1 1 1 1 1 1 1 1 1 1 1 1 1 1 1 1 1 1 0 2 2 2 2 0 1 1 1 1 1 1 1 0 0 10 4 10 0 1 
1 1 1 1 1 1 1 1 1 1 1 1 1 1 1 1 1 1 1 1 1 1 1 1 1 1 1 1 1 1 0 2 2 2 2 0 1 1 1 1 1 1 1 0 2 2 2 2 0 1 
1 1 1 1 1 1 1 1 1 1 1 1 1 1 1 1 1 1 1 1 1 1 1 1 1 1 1 1 1 1 0 2 2 2 2 0 0 1 1 1 1 1 1 0 2 2 2 2 0 1 
1 1 1 1 1 1 1 1 1 1 1 1 1 1 1 1 0 0 0 0 0 0 0 0 0 0 0 0 0 0 0 2 2 2 2 2 0 1 1 1 1 1 1 0 2 2 2 2 0 1 
1 1 1 1 1 1 1 1 1 1 1 1 1 1 1 1 0 2 2 0 2 2 2 2 2 2 2 11 2 2 2 2 2 2 2 2 0 0 0 0 0 0 0 0 2 2 2 2 0 1 
1 1 1 1 1 1 1 1 1 1 1 0 0 0 0 0 0 2 2 0 2 2 2 2 2 2 2 11 2 2 2 2 2 2 2 2 2 2 2 2 2 2 2 2 2 2 2 2 0 1 
1 1 1 1 1 1 1 1 1 1 1 0 4 4 2 2 2 2 2 0 2 0 0 0 0 0 0 0 0 0 0 2 2 2 2 2 2 2 2 2 2 2 2 2 2 2 2 2 0 1 
1 1 1 1 1 1 1 1 1 1 1 0 4 4 2 2 2 2 2 2 2 0 1 1 1 1 1 1 1 1 0 0 0 2 2 2 2 2 4 4 2 2 2 2 2 2 2 2 0 1 
1 1 1 1 1 1 1 1 1 1 1 0 4 2 2 2 2 2 2 2 12 0 1 0 0 0 0 0 0 1 1 0 0 2 2 2 2 2 4 4 2 2 2 2 2 2 2 2 0 1 
1 1 1 1 1 1 1 1 1 1 1 0 4 2 2 2 2 2 2 2 2 0 1 0 2 2 2 2 0 0 0 0 0 2 2 2 2 2 2 2 2 2 0 0 0 0 2 2 0 1 
1 1 1 1 1 1 1 1 1 1 1 0 2 2 10 2 2 2 10 2 2 0 1 0 2 2 2 2 2 2 2 2 2 2 2 2 2 2 2 2 2 2 0 1 1 0 2 2 0 1 
1 1 1 1 1 1 1 1 1 1 1 0 2 2 2 2 2 2 2 2 2 0 1 0 20 2 2 2 2 2 2 2 2 2 2 0 0 0 2 2 2 2 0 1 1 0 2 2 0 1 
1 1 1 1 0 0 0 0 0 1 1 0 2 2 2 2 11 2 2 2 2 0 1 0 2 2 2 2 2 0 0 0 0 0 0 0 1 0 0 2 2 2 0 1 1 0 9 9 0 1 
1 1 1 1 0 2 2 2 0 1 1 0 2 2 2 2 2 2 0 0 0 0 1 0 0 0 0 0 0 0 1 1 1 1 1 1 1 1 0 0 2 2 0 1 1 0 19 19 0 1 
1 1 1 1 0 2 2 2 0 1 0 0 2 2 2 2 2 2 0 1 1 1 1 1 1 1 1 1 1 1 1 1 1 1 1 1 1 1 1 1 0 0 0 1 1 0 0 0 0 1 
0 0 0 0 0 2 2 9 0 0 0 2 2 11 2 2 2 2 0 1 1 1 1 1 1 1 1 1 1 1 1 1 1 1 1 1 1 1 1 1 1 1 1 1 1 1 1 1 1 1 
0 10 9 2 2 2 2 2 2 2 2 2 2 2 2 2 2 2 0 1 1 1 1 1 1 1 1 1 1 1 1 1 1 1 1 1 1 1 1 1 1 1 1 1 1 1 1 1 1 1 
0 10 11 2 2 2 2 2 2 2 10 2 2 2 2 2 4 4 0 1 1 1 1 1 1 1 1 1 1 1 1 1 1 1 1 1 1 1 1 1 1 1 1 1 1 1 1 1 1 1 
0 2 2 2 0 0 0 2 2 2 2 2 2 2 0 0 0 0 0 1 1 1 1 1 1 1 1 1 1 1 1 1 1 1 1 1 1 1 1 1 1 1 1 1 1 1 1 1 1 1 
0 2 2 2 0 0 0 2 2 2 2 2 2 2 0 1 1 1 1 1 1 1 1 1 1 1 1 1 1 1 1 1 1 1 1 1 1 1 1 1 1 1 1 1 1 1 1 1 1 1 
0 2 2 2 0 0 0 2 2 11 2 2 2 2 0 1 1 1 1 1 1 1 1 1 1 1 1 1 1 1 1 1 1 1 1 1 1 1 1 1 1 1 1 1 1 1 1 1 1 1 
0 9 2 0 0 0 2 2 2 0 0 0 2 2 0 1 1 1 1 1 1 1 1 1 1 1 1 1 1 1 1 1 1 1 1 1 1 1 1 1 1 1 1 1 1 1 1 1 1 1 
0 2 2 0 0 0 2 2 2 0 0 0 2 2 0 1 1 1 1 1 1 1 1 1 1 1 1 1 1 1 1 1 1 1 1 1 1 1 1 1 1 1 1 1 1 1 1 1 1 1 
0 2 2 0 0 0 9 2 2 0 0 0 2 2 0 1 1 1 1 1 1 1 1 1 1 1 1 1 1 1 1 1 1 1 1 1 1 1 1 1 1 1 1 1 1 1 1 1 1 1 
0 2 2 2 2 2 2 2 0 0 0 2 2 11 0 1 1 1 1 1 1 1 1 1 1 1 1 1 1 1 1 1 1 1 1 1 1 1 1 1 1 1 1 1 1 1 1 1 1 1 
0 2 11 2 2 2 2 2 0 0 0 2 2 4 0 1 1 1 1 1 1 1 1 1 1 1 1 1 1 1 1 1 1 1 1 1 1 1 1 1 1 1 1 1 1 1 1 1 1 1 
0 2 2 2 2 2 2 2 0 0 0 2 2 4 0 1 1 1 1 1 1 1 1 1 1 1 1 1 1 1 1 1 1 1 1 1 1 1 1 1 1 1 1 1 1 1 1 1 1 1 
0 19 19 11 2 2 2 2 2 2 9 2 4 4 0 1 1 1 1 1 1 1 1 1 1 1 1 1 1 1 1 1 1 1 1 1 1 1 1 1 1 1 1 1 1 1 1 1 1 1 
0 0 0 0 0 0 0 0 0 0 0 0 0 0 0 1 1 1 1 1 1 1 1 1 1 1 1 1 1 1 1 1 1 1 1 1 1 1 1 1 1 1 1 1 1 1 1 1 1 1 
