1 1 1 1 1 1 1 1 1 1 1 1 1 1 1 1 1 1 1 1 1 1 1 1 1 1 1 1 1 1 1 1 1 1 1 1 1 1 1 1 1 1 1 1 1 1 1 1 1 1 
1 0 0 0 0 0 0 0 0 0 0 0 0 0 0 0 0 0 0 0 0 0 0 0 0 0 0 0 0 0 0 0 0 0 0 0 0 1 1 1 1 1 1 1 1 1 1 1 1 1 
1 0 26 2 2 2 2 2 2 2 2 2 2 2 10 2 2 2 2 2 2 2 2 2 2 2 2 2 2 2 2 2 2 2 2 2 0 1 1 1 1 1 1 1 1 1 1 1 1 1 
1 0 26 2 2 2 2 2 2 2 2 2 2 4 4 4 4 2 2 25 25 25 2 2 2 2 2 2 11 28 28 28 28 28 2 2 0 1 1 1 1 1 1 1 1 1 1 1 1 1 
1 0 26 2 2 2 2 2 2 2 2 2 2 2 2 2 2 2 2 25 25 25 2 2 2 2 2 2 2 2 2 2 2 28 2 2 0 0 25 25 25 25 25 25 25 25 0 0 1 1 
1 0 26 2 2 0 0 27 27 25 0 2 2 2 28 28 28 2 2 0 25 25 2 2 2 2 2 0 0 0 0 2 2 28 2 2 26 23 23 23 26 23 26 26 2 2 2 0 1 1 
1 0 26 24 2 25 25 28 28 0 25 2 2 28 2 2 2 28 2 0 25 25 2 2 2 2 0 0 1 1 0 2 2 28 2 2 23 26 26 26 27 23 2 2 2 2 2 25 1 1 
1 0 20 22 2 27 28 28 28 28 27 2 2 28 2 9 2 2 9 2 2 2 2 2 22 2 0 1 1 1 0 2 2 28 2 2 2 2 2 2 27 27 27 2 2 2 2 25 1 1 
1 0 23 26 2 0 25 28 28 25 25 2 2 28 2 19 28 28 2 0 0 0 2 2 2 2 0 1 1 1 0 2 2 28 28 28 28 28 28 28 28 28 2 2 2 2 19 25 1 1 
1 0 26 22 2 0 0 27 27 25 25 2 2 28 2 2 2 28 2 2 2 2 2 2 2 2 0 1 1 1 0 2 2 28 2 2 2 2 2 12 2 2 2 2 2 2 19 25 1 1 
1 0 2 2 2 2 2 2 26 2 2 2 2 2 28 28 28 28 9 2 2 22 2 2 2 2 0 1 1 1 0 2 2 28 2 2 2 23 2 2 2 2 2 2 2 10 19 25 1 1 
1 0 2 22 2 2 24 2 2 2 2 2 2 9 2 2 2 2 2 2 2 2 2 2 2 0 1 1 1 1 0 2 2 28 2 2 2 2 2 2 26 26 24 26 26 26 4 0 1 1 
1 0 0 0 0 0 0 0 0 25 25 25 25 25 25 25 25 25 25 25 25 25 25 0 0 0 1 1 1 1 0 27 2 28 2 2 2 27 27 27 0 0 0 26 11 4 4 0 1 1 
1 1 1 1 1 1 1 1 1 1 1 1 1 1 1 1 1 1 1 1 1 1 1 1 1 1 1 1 1 1 0 2 2 28 2 2 2 27 2 2 0 1 0 4 4 4 4 0 1 1 
1 1 1 1 1 1 1 1 1 1 1 1 1 1 1 1 1 1 1 1 1 1 1 1 1 1 1 1 1 1 0 27 2 28 2 2 2 2 2 2 0 1 0 0 0 0 0 0 1 1 
1 1 1 1 1 1 1 1 1 1 1 1 1 1 1 1 1 1 1 1 1 1 1 1 1 1 1 1 1 1 0 27 2 28 2 0 0 0 11 2 25 1 1 1 1 1 1 1 1 1 
1 1 1 1 1 1 1 1 1 1 1 1 1 1 1 1 1 1 1 1 1 1 1 1 1 1 1 1 1 1 0 2 27 28 2 0 1 0 2 9 25 1 1 1 1 1 1 1 1 1 
1 1 1 1 1 1 1 1 1 1 1 1 1 1 1 1 1 1 1 1 1 1 1 1 1 1 1 1 1 1 0 27 27 28 2 0 1 0 0 25 25 1 1 1 1 1 1 1 1 1 
1 1 1 1 1 1 1 1 1 1 1 1 1 1 1 1 1 1 1 1 1 1 1 1 1 1 1 1 1 1 0 2 23 28 2 0 1 1 1 1 1 1 1 1 1 1 1 1 1 1 
1 1 1 1 1 1 1 1 1 1 1 1 1 1 1 1 1 1 1 1 1 1 1 1 1 1 1 1 1 1 0 2 23 28 2 0 1 1 1 1 1 1 1 1 1 1 1 1 1 1 
1 1 1 1 1 1 1 1 1 1 1 1 1 1 1 1 1 1 1 1 1 1 1 1 1 1 1 1 1 1 0 2 2 28 2 0 1 1 1 1 1 1 1 1 0 0 0 0 0 1 
1 1 1 1 1 1 1 1 1 1 1 1 1 1 1 1 1 1 1 1 1 1 1 1 1 1 1 1 1 1 0 2 2 28 2 0 1 1 1 1 1 1 1 0 0 10 4 10 0 1 
1 1 1 1 1 1 1 1 1 1 1 1 1 1 1 1 1 1 1 1 1 1 1 1 1 1 1 1 1 1 0 2 2 28 2 0 1 1 1 1 1 1 1 0 2 27 27 27 0 1 
1 1 1 1 1 1 1 1 1 1 1 1 1 1 1 1 1 1 1 1 1 1 1 1 1 1 1 1 1 1 0 2 2 28 2 0 0 1 1 1 1 1 1 0 2 2 2 2 0 1 
1 1 1 1 1 1 1 1 1 1 1 1 1 1 1 1 0 0 0 0 0 0 0 0 0 0 0 0 0 0 0 2 2 28 2 2 0 1 1 1 1 1 1 25 2 2 2 2 0 1 
1 1 1 1 1 1 1 1 1 1 1 1 1 1 1 1 0 26 18 0 2 2 2 2 2 26 26 11 2 2 2 2 2 28 2 2 25 25 25 25 25 25 25 25 2 2 27 2 0 1 
1 1 1 1 1 1 1 1 1 1 1 0 0 0 0 0 0 26 26 0 28 28 28 28 28 28 28 11 28 28 28 28 28 28 28 28 28 2 2 2 2 24 24 2 2 2 2 27 0 1 
1 1 1 1 1 1 1 1 1 1 1 0 4 4 28 28 11 28 0 0 28 0 0 0 0 0 0 0 0 0 0 2 2 2 2 2 28 2 27 27 27 2 2 2 2 2 2 27 0 1 
1 1 1 1 1 1 1 1 1 1 1 0 4 4 28 2 0 28 28 28 28 0 1 1 1 1 1 1 1 1 0 0 0 2 2 2 28 2 4 4 27 2 2 2 2 2 27 27 0 1 
1 1 1 1 1 1 1 1 1 1 1 0 4 2 28 2 0 0 0 0 12 0 1 0 0 0 0 0 0 1 1 0 0 2 2 2 28 28 4 4 27 2 2 2 2 2 27 27 0 1 
1 1 1 1 1 1 1 1 1 1 1 0 4 2 28 2 2 2 2 0 0 0 1 0 18 27 27 27 0 0 0 0 0 2 2 2 28 2 2 2 27 2 25 25 0 0 27 27 0 1 
1 1 1 1 1 1 1 1 1 1 1 0 19 2 28 2 27 2 2 26 19 0 1 0 19 27 27 27 27 27 27 27 2 2 2 2 28 2 2 2 27 27 25 1 1 0 27 27 0 1 
1 1 1 1 1 1 1 1 1 1 1 0 19 2 28 2 27 27 2 22 24 0 1 0 19 27 27 27 27 2 2 2 27 27 27 25 6 25 2 2 2 27 25 1 1 0 27 27 0 1 
1 1 1 1 0 0 0 0 0 1 1 0 2 2 28 2 27 27 2 26 11 0 1 0 19 12 12 12 12 0 25 25 25 25 25 25 27 25 25 2 2 27 0 1 1 0 9 9 0 1 
1 1 1 1 0 5 2 2 0 1 1 0 2 2 28 2 27 2 0 0 0 0 1 0 0 0 0 0 0 0 19 19 19 19 19 19 27 18 25 25 27 27 0 1 1 0 19 19 0 1 
1 1 1 1 0 28 2 2 0 1 0 0 2 2 28 2 2 2 0 1 1 1 1 1 1 1 1 1 1 25 14 14 14 18 18 27 27 18 25 25 25 25 0 1 1 0 0 0 0 1 
0 0 0 0 0 28 2 9 0 0 0 2 2 11 28 2 2 2 0 1 1 1 1 1 1 1 1 1 1 25 25 25 25 25 25 25 25 25 25 25 25 25 1 1 1 1 1 1 1 1 
0 10 9 2 2 28 28 28 28 28 28 28 28 28 28 2 2 2 0 1 1 1 1 1 1 1 1 1 1 1 1 1 1 1 1 1 1 1 1 1 1 1 1 1 1 1 1 1 1 1 
0 10 11 28 28 28 2 28 2 2 10 2 2 2 2 2 4 4 0 1 1 1 1 1 1 1 1 1 1 1 1 1 1 1 1 1 1 1 1 1 1 1 1 1 1 1 1 1 1 1 
0 2 28 28 0 0 0 28 2 2 2 2 2 2 0 0 0 0 0 1 1 1 1 1 1 1 1 1 1 1 1 1 1 1 1 1 1 1 1 1 1 1 1 1 1 1 1 1 1 1 
0 2 28 2 0 0 0 28 2 2 2 2 2 2 0 1 1 1 1 1 1 1 1 1 1 1 1 1 1 1 1 1 1 1 1 1 1 1 1 1 1 1 1 1 1 1 1 1 1 1 
0 2 28 2 0 0 0 28 2 11 2 2 2 2 0 1 1 1 1 1 1 1 1 1 1 1 1 1 1 1 1 1 1 1 1 1 1 1 1 1 1 1 1 1 1 1 1 1 1 1 
0 9 28 0 0 0 2 28 2 0 0 0 2 2 0 1 1 1 1 1 1 1 1 1 1 1 1 1 1 1 1 1 1 1 1 1 1 1 1 1 1 1 1 1 1 1 1 1 1 1 
0 2 28 0 0 0 2 28 2 0 0 0 2 2 0 1 1 1 1 1 1 1 1 1 1 1 1 1 1 1 1 1 1 1 1 1 1 1 1 1 1 1 1 1 1 1 1 1 1 1 
0 2 28 6 8 0 9 28 2 0 0 0 2 2 0 1 1 1 1 1 1 1 1 1 1 1 1 1 1 1 1 1 1 1 1 1 1 1 1 1 1 1 1 1 1 1 1 1 1 1 
0 2 28 28 2 2 2 28 0 0 0 2 2 11 0 1 1 1 1 1 1 1 1 1 1 1 1 1 1 1 1 1 1 1 1 1 1 1 1 1 1 1 1 1 1 1 1 1 1 1 
0 2 11 28 2 2 2 28 0 0 0 2 26 4 0 1 1 1 1 1 1 1 1 1 1 1 1 1 1 1 1 1 1 1 1 1 1 1 1 1 1 1 1 1 1 1 1 1 1 1 
0 2 2 28 28 2 2 28 6 7 0 26 26 4 0 1 1 1 1 1 1 1 1 1 1 1 1 1 1 1 1 1 1 1 1 1 1 1 1 1 1 1 1 1 1 1 1 1 1 1 
0 19 19 11 28 28 28 28 28 2 9 26 4 4 0 1 1 1 1 1 1 1 1 1 1 1 1 1 1 1 1 1 1 1 1 1 1 1 1 1 1 1 1 1 1 1 1 1 1 1 
0 0 0 0 0 0 0 0 0 0 0 0 0 0 0 1 1 1 1 1 1 1 1 1 1 1 1 1 1 1 1 1 1 1 1 1 1 1 1 1 1 1 1 1 1 1 1 1 1 1 
