1 1 1 1 1 1 0 0 0 0 0 0 0 1 1 1 1 25 25 25 25 25 25 25 25 0 0 0 0 0 0 0 0 0 0 0 0 0 0 0 0 0 25 25 25 25 25 25 25 0 
1 1 1 1 1 1 0 2 2 2 2 2 0 1 1 1 1 25 2 2 2 2 2 2 2 2 2 2 24 2 2 2 23 2 2 2 2 2 2 2 2 2 2 2 2 2 2 19 19 0 
1 1 1 1 1 1 0 2 2 20 2 2 0 1 1 1 1 25 2 2 2 2 2 2 2 2 23 2 23 23 2 2 2 2 2 2 2 2 2 2 2 2 2 2 2 2 2 2 19 25 
0 0 0 0 0 1 0 2 2 2 2 2 0 1 25 25 25 25 2 2 2 2 2 2 2 2 2 2 2 2 2 2 2 2 2 2 2 2 2 2 0 2 2 2 2 11 2 2 2 25 
0 2 2 2 0 1 0 2 2 2 2 2 0 1 25 2 2 2 2 2 2 2 2 0 0 0 0 0 0 0 0 0 2 2 2 2 2 2 2 0 25 0 2 2 2 2 2 2 2 25 
0 2 2 2 0 1 0 2 2 2 2 2 0 1 25 2 2 2 2 2 2 2 2 0 1 1 1 1 1 1 1 0 2 2 2 2 2 2 0 25 6 7 25 2 2 2 2 2 2 0 
0 2 2 2 0 1 0 2 2 2 2 2 0 1 25 2 2 2 2 23 23 2 2 0 1 1 1 1 1 1 1 0 2 2 2 2 2 2 2 24 2 2 2 2 2 2 2 11 2 0 
0 2 2 2 0 0 0 2 2 2 2 2 0 0 0 2 2 2 2 23 23 11 2 0 1 1 1 1 1 1 1 0 2 2 2 0 2 2 2 2 2 2 2 2 2 0 2 2 2 0 
0 2 2 2 2 2 2 2 2 23 23 2 2 2 2 2 2 2 2 2 23 2 2 0 1 1 1 1 1 1 1 0 2 2 0 25 2 2 2 2 10 2 2 2 2 0 0 2 2 0 
0 2 2 2 2 2 2 2 2 23 2 2 2 2 2 2 2 2 2 2 23 2 25 0 1 1 1 1 1 1 1 0 2 0 25 0 2 2 2 10 19 10 2 2 2 0 25 25 2 0 
0 0 0 0 25 25 25 25 25 25 2 2 0 0 0 25 2 2 2 11 2 25 25 0 1 1 1 1 1 1 1 0 2 2 25 25 2 2 2 2 10 2 2 2 2 25 25 2 2 0 
1 1 1 25 25 25 25 0 0 0 2 2 0 0 25 25 0 0 0 0 0 0 25 25 1 1 1 1 1 1 1 0 2 2 2 0 2 2 2 2 2 2 2 2 2 25 2 2 2 0 
1 1 1 0 2 2 2 2 2 2 2 2 2 2 2 2 2 2 2 2 0 1 1 1 1 1 1 1 1 1 1 0 2 2 2 2 2 2 2 2 2 2 2 2 2 2 2 2 2 0 
1 1 1 0 2 2 2 2 2 2 2 2 2 2 2 2 2 2 2 2 0 0 0 0 0 0 0 0 0 0 1 0 2 2 11 2 2 2 0 25 25 0 0 2 2 11 2 2 2 0 
1 1 1 0 2 2 2 2 25 0 0 0 0 0 0 0 0 0 2 2 2 2 2 2 2 2 2 10 19 0 1 0 2 2 2 2 2 2 2 0 25 25 2 2 2 2 2 2 2 25 
1 1 1 0 2 2 0 25 25 1 1 1 1 1 1 1 1 0 2 2 2 2 2 2 2 2 2 10 10 0 1 0 2 2 2 2 2 2 2 2 0 2 2 2 2 2 2 2 2 25 
1 1 1 0 2 2 0 25 1 1 1 1 1 1 1 1 1 0 0 0 0 0 0 0 0 0 0 0 0 0 1 0 2 2 2 2 11 2 2 2 2 2 2 2 2 2 2 2 2 25 
1 1 1 0 2 2 25 0 0 0 0 0 0 0 0 0 0 0 1 1 1 1 1 1 1 1 1 1 1 1 1 0 2 2 2 2 2 2 2 2 2 2 2 2 2 11 2 2 17 0 
1 1 1 0 2 2 0 0 11 0 11 0 11 0 0 16 23 0 1 1 1 1 1 1 1 1 1 1 1 1 1 0 0 0 0 0 0 25 25 25 25 25 25 25 25 25 25 25 25 25 
1 1 1 0 2 2 2 2 2 2 2 22 22 22 2 2 23 0 1 1 1 1 1 1 1 1 1 1 1 1 1 1 1 1 1 1 1 1 1 1 1 1 1 1 1 1 1 1 1 1 
1 1 1 0 2 2 2 2 24 23 23 2 2 22 2 2 2 0 1 1 1 1 1 1 1 1 1 1 1 1 1 1 1 1 1 1 1 1 1 1 1 1 1 1 1 1 1 1 1 1 
1 1 1 0 0 0 0 0 0 0 0 0 0 0 0 2 23 0 1 1 1 1 1 1 1 1 1 1 1 1 1 1 1 1 1 1 1 1 1 1 1 1 1 1 1 1 1 1 1 1 
1 1 1 0 0 0 0 0 0 0 0 0 0 0 0 2 23 0 1 1 1 1 1 1 1 1 1 1 1 1 1 1 1 1 1 1 1 1 1 1 1 1 1 1 1 1 1 1 1 1 
1 1 1 0 2 2 22 23 23 2 2 22 2 22 2 2 2 0 1 1 1 1 1 1 1 1 1 1 1 1 1 1 1 1 1 1 1 1 1 1 1 1 1 1 1 1 1 1 1 1 
1 1 1 0 2 2 22 2 23 2 22 2 23 2 22 2 2 0 1 1 1 1 1 1 1 1 1 1 1 1 1 1 1 1 1 1 1 1 1 1 1 1 1 1 1 1 1 1 1 1 
1 1 1 0 2 2 25 11 0 11 0 11 0 11 0 0 0 0 1 1 1 1 1 1 1 1 1 1 1 1 1 1 1 1 1 1 1 1 1 1 1 1 1 1 1 1 1 1 1 1 
1 1 1 0 2 2 25 25 25 25 25 25 25 25 25 0 0 0 0 1 1 1 1 1 1 1 1 1 1 1 1 1 1 1 1 1 1 1 1 1 1 1 1 1 1 1 1 1 1 1 
1 1 1 0 2 2 2 2 2 2 2 2 2 2 2 2 2 2 0 1 1 1 1 1 1 1 1 1 1 1 1 1 1 1 1 1 1 1 1 1 1 1 1 1 1 1 1 1 1 1 
1 1 1 0 2 2 2 2 2 2 2 2 2 2 2 2 2 2 0 0 0 0 1 1 1 1 1 1 1 1 1 1 1 1 1 1 1 1 1 1 1 1 1 1 1 1 1 1 1 1 
1 1 1 0 2 9 2 2 2 2 2 2 2 2 2 2 2 2 2 2 2 0 1 1 1 1 1 1 1 1 1 1 1 1 1 1 1 1 1 1 1 1 1 1 1 1 1 1 1 1 
1 1 1 0 2 2 2 2 2 2 2 2 2 9 2 2 2 2 9 2 2 0 1 1 1 1 1 1 1 1 1 1 1 1 1 1 1 1 1 1 1 1 1 1 1 1 1 1 1 1 
1 1 1 0 2 2 2 2 23 2 2 2 2 2 2 2 2 2 2 2 2 0 1 1 1 1 1 1 1 1 1 1 1 1 1 1 1 1 1 1 1 1 1 1 1 1 1 1 1 1 
1 1 1 0 2 2 2 2 2 2 2 2 2 2 2 2 2 2 2 2 2 0 1 1 1 1 1 1 1 1 1 1 1 1 1 1 1 1 1 1 1 1 1 1 1 1 1 1 1 1 
1 1 1 0 2 2 2 2 2 2 9 2 2 2 2 2 2 0 0 0 0 0 1 1 0 0 0 0 0 0 0 0 25 25 25 1 1 1 1 1 1 1 1 1 1 1 1 1 1 1 
1 1 1 0 2 9 2 2 2 2 2 2 2 2 2 2 2 0 1 1 1 1 1 1 0 2 2 2 2 2 2 2 2 19 25 1 1 1 1 1 1 1 1 1 1 1 1 1 1 1 
1 1 1 0 2 2 2 2 2 2 2 2 2 2 2 2 2 0 1 1 1 25 25 25 0 2 2 2 2 2 2 2 2 2 25 1 1 1 1 1 1 1 1 1 1 1 1 1 1 1 
0 0 0 0 2 2 2 2 2 2 2 2 2 2 2 2 2 0 1 1 1 25 2 2 2 2 2 9 2 2 2 9 2 25 25 1 1 1 1 1 1 1 1 1 1 1 1 1 1 1 
25 6 7 25 2 2 2 2 2 2 2 2 2 2 9 2 2 0 1 1 1 25 2 2 2 2 2 2 2 23 2 2 2 25 0 1 1 1 1 1 1 1 1 1 1 1 1 1 1 1 
25 2 2 2 2 2 2 2 2 9 2 2 2 2 2 2 24 25 25 25 25 0 2 9 2 2 2 2 2 2 2 2 2 25 25 1 1 1 1 1 1 1 1 1 1 1 1 1 1 1 
25 2 2 2 2 2 2 2 2 2 2 2 2 22 2 2 2 2 2 2 2 2 2 2 2 2 2 9 2 23 2 2 9 2 25 1 1 1 1 1 1 1 1 1 1 1 1 1 1 1 
25 2 2 9 2 2 2 2 2 2 2 2 2 22 2 2 2 2 2 2 9 2 2 2 2 2 2 2 2 2 2 2 2 2 25 1 1 1 1 1 1 1 1 1 1 1 1 1 1 1 
25 2 2 2 2 2 2 2 9 2 2 2 2 22 22 2 9 2 25 0 0 2 2 2 2 2 2 9 2 2 25 25 25 25 25 1 1 1 1 1 1 1 1 1 1 1 1 1 1 1 
25 2 2 2 2 2 2 2 2 2 2 2 2 2 22 2 2 2 25 1 0 2 2 2 2 2 2 2 2 2 25 1 1 1 1 1 1 1 1 1 1 1 1 1 1 1 1 1 1 1 
0 2 2 25 25 25 25 2 2 2 2 2 2 9 2 2 2 2 25 1 0 2 2 2 2 2 2 2 2 2 25 1 1 1 1 1 1 1 1 1 1 1 1 1 1 1 1 1 1 1 
0 2 2 25 25 1 25 2 2 2 2 2 2 2 2 2 2 2 25 1 0 0 0 0 0 2 2 2 2 2 0 1 1 1 1 1 1 1 1 1 1 1 1 1 1 1 1 1 1 1 
0 2 10 0 1 1 25 0 0 0 0 0 0 0 0 0 0 0 25 1 1 1 1 1 0 2 2 2 2 2 0 1 1 1 1 1 1 1 1 1 1 1 1 1 1 1 1 1 1 1 
0 5 2 0 1 1 1 1 1 1 1 1 1 1 1 1 1 1 1 1 1 1 1 1 0 2 2 2 2 2 0 1 1 1 1 1 1 1 1 1 1 1 1 1 1 1 1 1 1 1 
0 0 0 0 1 1 1 1 1 1 1 1 1 1 1 1 1 1 1 1 1 1 1 1 0 0 0 0 0 0 0 1 1 1 1 1 1 1 1 1 1 1 1 1 1 1 1 1 1 1 
1 1 1 1 1 1 1 1 1 1 1 1 1 1 1 1 1 1 1 1 1 1 1 1 1 1 1 1 1 1 1 1 1 1 1 1 1 1 1 1 1 1 1 1 1 1 1 1 1 1 
1 1 1 1 1 1 1 1 1 1 1 1 1 1 1 1 1 1 1 1 1 1 1 1 1 1 1 1 1 1 1 1 1 1 1 1 1 1 1 1 1 1 1 1 1 1 1 1 1 1 
