0 0 0 0 0 0 0 25 25 25 25 25 25 25 25 0 1 1 1 1 1 1 1 1 1 1 1 1 1 1 1 1 1 1 1 1 1 1 1 1 25 25 25 25 25 25 25 25 25 0 
0 21 2 2 2 2 2 25 10 11 10 11 10 11 10 0 1 1 1 1 1 1 1 1 1 1 1 1 1 1 1 1 1 1 1 1 1 1 1 1 0 24 2 11 11 11 11 11 2 25 
0 2 2 2 2 2 2 25 2 2 9 2 2 2 2 0 1 1 1 1 1 1 1 1 1 1 1 1 1 1 1 1 1 1 1 1 1 1 1 1 0 2 2 2 2 3 2 2 22 0 
0 19 2 2 9 2 2 2 2 2 2 2 2 2 2 0 1 1 1 1 1 1 1 1 1 1 1 1 1 1 1 1 1 1 1 1 1 1 1 1 0 22 22 22 2 2 2 2 2 25 
0 2 2 2 2 2 2 2 2 9 2 2 2 2 2 0 1 1 1 1 1 1 1 1 1 1 1 1 1 1 1 1 1 1 1 1 1 1 1 1 0 0 0 25 25 2 0 0 0 0 
0 2 2 2 2 2 2 0 2 11 2 11 2 2 11 0 1 1 1 1 1 1 1 1 1 1 1 1 1 1 1 1 1 1 1 1 1 1 1 1 1 1 1 1 25 2 0 1 1 1 
0 25 25 25 25 25 25 25 25 25 25 25 2 0 0 0 0 0 0 0 0 0 0 0 0 0 0 0 0 0 1 1 1 1 1 1 1 1 1 1 1 1 1 1 25 2 0 1 1 1 
0 2 24 0 2 2 0 2 2 0 0 0 2 2 2 2 2 2 2 2 2 2 10 2 2 2 2 2 0 0 1 1 1 1 1 1 1 1 1 1 1 1 1 1 25 2 0 1 1 1 
0 2 0 2 2 2 2 0 2 2 2 2 2 2 0 2 0 2 2 2 2 2 2 0 2 2 0 2 2 0 1 1 1 1 1 1 1 1 1 1 1 1 1 1 25 2 0 1 1 1 
0 2 2 2 2 2 9 2 2 2 0 2 0 2 2 0 2 0 2 2 2 2 0 2 2 0 2 2 2 0 1 1 1 1 1 1 1 1 1 1 1 1 1 1 25 2 0 1 1 1 
0 2 2 2 2 2 2 2 2 2 0 2 2 2 2 2 2 2 2 2 2 2 2 2 0 23 2 25 2 0 1 1 1 1 1 1 1 1 1 1 1 1 1 1 0 2 0 1 1 1 
0 19 2 2 10 2 2 2 2 2 0 0 0 0 0 0 0 0 0 0 25 25 25 0 2 23 25 2 2 25 1 1 1 1 1 1 1 1 1 1 1 1 1 1 0 2 25 1 1 1 
0 0 2 2 2 2 2 11 2 0 0 2 2 2 2 2 2 2 2 11 2 11 2 11 2 2 2 2 0 25 1 1 1 1 1 1 1 1 1 1 1 1 1 1 0 2 25 1 1 1 
0 0 0 2 2 2 2 2 0 25 25 0 2 2 2 2 2 2 2 2 2 2 2 2 2 2 2 0 25 25 1 1 1 1 1 1 1 1 1 1 1 1 1 1 0 19 25 1 1 1 
0 0 0 0 0 0 0 0 0 0 25 25 0 0 2 0 0 0 0 0 0 0 0 0 0 0 0 25 25 25 0 0 0 0 0 0 0 0 1 1 1 1 1 1 0 19 25 1 1 1 
1 1 1 1 1 1 1 1 1 1 0 25 0 0 2 0 0 6 8 0 0 0 0 0 0 0 6 7 0 0 0 25 25 25 25 25 25 25 1 1 1 1 1 1 0 19 25 1 1 1 
1 1 1 1 1 1 1 1 1 1 0 25 25 2 2 2 0 2 2 0 0 2 19 2 0 0 2 2 2 2 2 25 2 2 2 2 0 0 1 1 1 1 1 1 0 2 0 1 1 1 
1 1 1 1 1 1 1 1 1 1 0 0 2 2 2 2 0 2 2 2 2 2 2 2 2 2 2 2 2 2 2 25 2 2 23 2 2 0 1 1 1 1 1 1 0 2 0 1 1 1 
1 1 1 1 1 1 1 1 1 1 0 9 2 2 2 2 0 2 2 2 0 0 25 25 25 2 2 2 2 2 2 25 2 2 23 2 2 0 1 1 1 1 1 1 0 2 0 1 1 1 
1 1 1 1 1 1 1 1 1 1 25 9 2 2 2 2 0 0 0 0 25 25 25 2 25 0 0 0 0 2 0 25 0 23 23 2 9 0 1 1 1 1 1 1 25 2 0 1 1 1 
1 1 1 1 1 1 1 1 1 1 25 9 2 2 2 2 2 2 2 2 2 2 2 2 2 2 2 0 2 2 2 2 2 2 2 2 2 0 1 1 1 1 1 1 25 2 0 1 1 1 
1 1 1 1 1 1 1 1 1 1 25 2 2 2 2 2 25 25 25 2 2 2 2 2 2 2 2 25 2 2 23 23 23 2 2 2 2 0 1 1 1 1 1 1 25 2 25 25 25 25 
1 1 1 1 1 1 1 1 1 1 25 2 2 2 2 2 25 0 25 2 2 2 2 2 2 2 2 25 2 2 2 2 2 2 2 2 2 0 1 1 1 1 1 1 25 2 2 2 15 0 
1 1 1 1 1 1 1 1 1 1 25 2 2 2 2 2 0 25 25 2 2 2 2 2 2 2 2 25 0 0 0 0 0 0 0 2 0 0 1 1 1 1 1 1 0 2 2 2 24 0 
1 1 1 1 1 1 1 1 1 1 25 2 2 2 2 2 2 2 2 2 2 23 23 2 2 2 2 25 23 23 23 2 2 2 2 2 2 0 1 1 1 1 1 1 0 2 23 23 2 0 
25 25 25 25 25 25 25 25 0 0 0 2 2 2 2 2 2 2 2 2 2 2 2 24 2 25 2 2 23 2 2 2 25 25 0 0 0 0 1 1 1 1 1 1 7 2 2 23 2 8 
25 0 4 4 4 4 4 4 4 4 0 2 2 2 2 2 2 2 2 2 2 2 2 2 2 2 2 0 0 25 25 25 25 2 2 2 2 0 1 1 1 1 1 1 6 2 2 2 2 6 
25 4 4 19 2 2 2 2 2 2 0 2 2 2 2 2 2 2 2 2 2 2 2 2 2 2 2 2 2 23 23 2 2 2 2 2 2 0 1 1 1 1 1 1 0 19 19 19 19 0 
25 4 18 19 2 2 2 2 2 2 2 2 2 2 2 2 2 2 2 2 2 2 2 2 2 2 2 2 2 2 2 2 2 2 2 2 22 0 1 1 1 1 1 1 0 0 0 0 0 0 
25 4 4 19 2 2 2 2 2 2 0 2 2 2 2 2 2 23 23 2 2 2 0 2 2 25 2 2 2 2 2 2 2 2 2 2 22 0 1 1 1 1 1 1 1 1 1 1 1 1 
25 0 4 4 4 4 4 4 4 4 0 2 2 2 2 2 2 2 23 2 2 2 2 2 2 2 2 2 2 2 2 2 2 2 2 22 22 0 1 1 1 1 1 1 1 1 1 1 1 1 
25 25 25 25 25 25 25 0 0 0 0 2 2 2 2 2 2 2 2 2 2 2 2 2 2 2 2 2 2 2 2 2 2 2 2 22 2 0 1 1 1 1 1 1 1 1 1 1 1 1 
1 1 1 1 1 1 1 1 1 1 0 0 0 0 2 0 0 0 0 0 0 0 0 25 25 25 25 25 25 25 25 25 25 2 0 0 0 0 1 1 1 1 1 1 1 1 1 1 1 1 
1 1 1 1 1 1 1 1 1 1 0 0 0 0 2 0 0 0 25 25 25 25 25 25 25 25 25 25 25 25 25 25 0 2 0 0 0 0 1 1 1 1 1 1 1 1 1 1 1 1 
1 1 1 1 1 1 1 1 1 1 0 0 2 2 2 2 2 2 25 25 0 2 2 2 2 2 2 2 2 0 4 2 0 2 0 2 2 0 1 1 1 1 1 1 1 1 1 1 1 1 
1 1 1 1 1 1 1 1 1 1 0 2 2 2 2 2 2 2 2 25 25 2 2 4 19 10 4 2 2 0 4 2 2 2 2 2 2 0 1 1 1 1 1 1 1 1 1 1 1 1 
1 1 1 1 1 1 1 1 1 1 0 2 2 0 2 23 0 2 2 2 2 2 2 4 4 4 4 2 2 2 2 2 2 2 2 2 19 0 1 1 1 1 1 1 1 1 1 1 1 1 
1 1 1 1 1 1 1 1 1 1 0 2 2 0 2 2 0 2 2 2 0 23 23 2 2 2 2 2 2 0 4 2 2 2 9 2 2 0 1 1 1 1 1 1 1 1 1 1 1 1 
1 1 1 1 1 1 1 1 1 1 0 2 2 2 2 2 2 2 2 0 0 2 2 2 2 2 2 2 2 0 4 2 0 2 0 2 2 0 1 1 1 1 1 1 1 1 1 1 1 1 
1 1 1 1 1 1 1 1 1 1 1 0 2 2 2 2 2 2 0 0 0 0 2 2 2 2 2 2 2 0 4 2 2 2 2 2 2 0 1 1 1 1 1 1 1 1 1 1 1 1 
1 1 1 1 1 1 1 1 1 1 1 0 0 0 0 0 0 0 0 0 0 0 0 0 2 2 0 0 0 0 0 0 0 0 0 0 0 0 1 1 1 1 1 1 1 1 1 1 1 1 
0 0 0 0 0 0 0 1 1 1 1 0 0 0 0 0 0 0 0 0 0 0 0 0 2 2 0 0 0 0 1 1 1 1 1 1 1 1 1 1 1 1 1 1 1 1 1 1 1 1 
0 0 2 2 2 2 0 0 1 1 0 0 4 4 22 4 4 4 0 0 0 0 2 2 2 2 23 23 0 0 1 1 1 1 1 1 1 1 1 1 1 1 1 1 1 1 1 1 1 1 
0 2 2 2 2 2 2 0 0 0 0 4 4 2 22 2 2 4 4 0 0 2 0 0 2 2 0 0 2 0 1 1 1 1 1 1 1 1 1 1 1 1 1 1 1 1 1 1 1 1 
0 2 2 2 11 2 11 2 2 0 0 2 2 2 22 2 2 2 2 2 0 2 0 2 2 2 2 0 2 0 1 1 1 1 1 1 1 1 1 1 1 1 1 1 1 1 1 1 1 1 
0 2 19 2 2 2 2 2 2 2 2 2 2 2 2 2 22 22 2 2 2 2 0 2 23 2 2 0 2 0 1 1 1 1 1 1 1 1 1 1 1 1 1 1 1 1 1 1 1 1 
0 2 2 2 2 2 2 2 2 0 0 2 2 2 2 24 2 2 2 2 0 2 2 23 23 2 2 2 3 0 1 1 1 1 1 1 1 1 1 1 1 1 1 1 1 1 1 1 1 1 
0 2 2 2 11 2 0 0 0 0 0 4 2 2 2 2 2 2 4 0 0 2 2 2 2 2 2 2 2 0 1 1 1 1 1 1 1 1 1 1 1 1 1 1 1 1 1 1 1 1 
0 0 2 2 2 2 0 0 1 1 0 0 4 4 4 4 4 4 4 0 0 0 2 2 2 20 2 2 0 0 1 1 1 1 1 1 1 1 1 1 1 1 1 1 1 1 1 1 1 1 
0 0 0 0 0 0 0 1 1 1 1 0 0 0 0 0 0 0 0 1 0 0 0 0 0 0 0 0 0 0 1 1 1 1 1 1 1 1 1 1 1 1 1 1 1 1 1 1 1 1 
