0 0 0 0 0 0 0 0 0 0 0 0 0 0 0 0 1 1 1 1 1 1 1 1 1 1 1 1 1 1 1 1 1 1 1 1 1 1 1 1 0 0 0 0 0 0 0 0 0 0 
0 5 2 2 2 2 2 0 2 2 2 2 2 2 2 0 1 1 1 1 1 1 1 1 1 1 1 1 1 1 1 1 1 1 1 1 1 1 1 1 0 2 2 11 11 11 11 11 2 0 
0 2 2 2 2 2 2 0 2 2 9 2 2 2 2 0 1 1 1 1 1 1 1 1 1 1 1 1 1 1 1 1 1 1 1 1 1 1 1 1 0 2 2 2 2 3 2 2 2 0 
0 19 2 2 9 2 2 2 2 2 2 2 2 2 2 0 1 1 1 1 1 1 1 1 1 1 1 1 1 1 1 1 1 1 1 1 1 1 1 1 0 2 2 2 2 2 2 2 2 0 
0 2 2 2 2 2 2 2 2 9 2 2 2 2 2 0 1 1 1 1 1 1 1 1 1 1 1 1 1 1 1 1 1 1 1 1 1 1 1 1 0 0 0 0 0 2 0 0 0 0 
0 2 2 2 2 2 2 0 2 2 2 2 2 2 2 0 1 1 1 1 1 1 1 1 1 1 1 1 1 1 1 1 1 1 1 1 1 1 1 1 1 1 1 1 0 2 0 1 1 1 
0 0 0 0 0 0 0 0 0 0 0 0 2 0 0 0 0 0 0 0 0 0 0 0 0 0 0 0 0 0 1 1 1 1 1 1 1 1 1 1 1 1 1 1 0 2 0 1 1 1 
0 2 2 0 2 2 0 2 2 0 0 0 2 2 2 2 2 2 2 2 2 2 10 2 2 2 2 2 0 0 1 1 1 1 1 1 1 1 1 1 1 1 1 1 0 2 0 1 1 1 
0 2 0 2 2 2 2 0 2 2 2 2 2 2 0 2 0 2 2 2 2 2 2 0 2 2 0 2 2 0 1 1 1 1 1 1 1 1 1 1 1 1 1 1 0 2 0 1 1 1 
0 2 2 2 2 2 9 2 2 2 0 2 0 2 2 0 2 0 2 2 2 2 0 2 2 0 2 2 2 0 1 1 1 1 1 1 1 1 1 1 1 1 1 1 0 2 0 1 1 1 
0 2 2 2 2 2 2 2 2 2 0 2 2 2 2 2 2 2 2 2 2 2 2 2 0 2 2 0 2 0 1 1 1 1 1 1 1 1 1 1 1 1 1 1 0 2 0 1 1 1 
0 19 2 2 10 2 2 2 2 2 0 0 0 0 0 0 0 0 0 0 0 0 0 0 2 2 0 2 2 0 1 1 1 1 1 1 1 1 1 1 1 1 1 1 0 2 0 1 1 1 
0 0 2 2 2 2 2 11 2 0 0 2 2 2 2 2 2 2 2 11 2 11 2 11 2 2 2 2 0 0 1 1 1 1 1 1 1 1 1 1 1 1 1 1 0 2 0 1 1 1 
0 0 0 2 2 2 2 2 0 0 0 0 2 2 2 2 2 2 2 2 2 2 2 2 2 2 2 0 0 0 1 1 1 1 1 1 1 1 1 1 1 1 1 1 0 2 0 1 1 1 
0 0 0 0 0 0 0 0 0 0 0 0 0 0 2 0 0 0 0 0 0 0 0 0 0 0 0 0 0 0 0 0 0 0 0 0 0 0 1 1 1 1 1 1 0 2 0 1 1 1 
1 1 1 1 1 1 1 1 1 1 0 0 0 0 2 0 0 6 8 0 0 0 0 0 0 0 6 7 0 0 0 0 0 0 0 0 0 0 1 1 1 1 1 1 0 2 0 1 1 1 
1 1 1 1 1 1 1 1 1 1 0 0 0 2 2 2 0 2 2 0 0 2 19 2 0 0 2 2 2 2 2 0 2 2 2 2 0 0 1 1 1 1 1 1 0 2 0 1 1 1 
1 1 1 1 1 1 1 1 1 1 0 0 2 2 2 2 0 2 2 2 2 2 2 2 2 2 2 2 2 2 2 0 2 2 2 2 2 0 1 1 1 1 1 1 0 2 0 1 1 1 
1 1 1 1 1 1 1 1 1 1 0 9 2 2 2 2 0 2 2 2 0 0 0 0 0 2 2 2 2 2 2 0 2 2 2 2 2 0 1 1 1 1 1 1 0 2 0 1 1 1 
1 1 1 1 1 1 1 1 1 1 0 9 2 2 2 2 0 0 0 0 0 2 2 2 0 0 0 0 0 2 0 0 0 2 2 2 9 0 1 1 1 1 1 1 0 2 0 1 1 1 
1 1 1 1 1 1 1 1 1 1 0 9 2 2 2 2 2 2 2 2 2 2 2 2 2 2 2 0 2 2 2 2 2 2 2 2 2 0 1 1 1 1 1 1 0 2 0 1 1 1 
1 1 1 1 1 1 1 1 1 1 0 2 2 2 2 2 0 0 0 2 2 2 2 2 2 2 2 0 2 2 2 2 2 2 2 2 2 0 1 1 1 1 1 1 0 2 0 0 0 0 
1 1 1 1 1 1 1 1 1 1 0 2 2 2 2 2 0 0 0 2 2 2 2 2 2 2 2 0 2 2 2 2 2 2 2 2 2 0 1 1 1 1 1 1 0 2 2 2 2 0 
1 1 1 1 1 1 1 1 1 1 0 2 2 2 2 2 0 0 0 2 2 2 2 2 2 2 2 0 0 0 0 0 0 0 0 2 0 0 1 1 1 1 1 1 0 2 2 2 2 0 
1 1 1 1 1 1 1 1 1 1 0 2 2 2 2 2 2 2 2 2 2 2 2 2 2 2 2 0 2 2 2 2 2 2 2 2 2 0 1 1 1 1 1 1 0 2 2 2 2 0 
0 0 0 0 0 0 0 0 0 0 0 2 2 2 2 2 2 2 2 2 2 2 2 2 2 0 2 2 2 2 2 2 0 0 0 0 0 0 1 1 1 1 1 1 0 2 2 2 2 0 
0 0 4 4 4 4 4 4 4 4 0 2 2 2 2 2 2 2 2 2 2 2 2 2 2 2 2 0 0 0 0 0 0 2 2 2 2 0 1 1 1 1 1 1 0 2 2 2 2 0 
0 4 4 2 2 2 2 2 2 2 0 2 2 2 2 2 2 2 2 2 2 2 2 2 2 2 2 2 2 2 2 2 2 2 2 2 2 0 1 1 1 1 1 1 0 2 2 2 19 0 
0 4 2 19 2 2 2 2 2 2 2 2 2 2 2 2 2 2 2 2 2 2 2 2 2 2 2 2 2 2 2 2 2 2 2 2 2 0 1 1 1 1 1 1 0 0 0 0 0 0 
0 4 4 2 2 2 2 2 2 2 0 2 2 2 2 2 2 2 2 2 2 2 0 2 2 0 2 2 2 2 2 2 2 2 2 2 2 0 1 1 1 1 1 1 1 1 1 1 1 1 
0 0 4 4 4 4 4 4 4 4 0 2 2 2 2 2 2 2 2 2 2 2 2 2 2 2 2 2 2 2 2 2 2 2 2 2 2 0 1 1 1 1 1 1 1 1 1 1 1 1 
0 0 0 0 0 0 0 0 0 0 0 2 2 2 2 2 2 2 2 2 2 2 2 2 2 2 2 2 2 2 2 2 2 2 2 2 2 0 1 1 1 1 1 1 1 1 1 1 1 1 
1 1 1 1 1 1 1 1 1 1 0 0 0 0 2 0 0 0 0 0 0 0 0 0 0 0 0 0 0 0 0 0 0 2 0 0 0 0 1 1 1 1 1 1 1 1 1 1 1 1 
1 1 1 1 1 1 1 1 1 1 0 0 0 0 2 0 0 0 0 0 0 0 0 0 0 0 0 0 0 0 0 0 0 2 0 0 0 0 1 1 1 1 1 1 1 1 1 1 1 1 
1 1 1 1 1 1 1 1 1 1 0 0 2 2 2 2 2 2 0 0 0 2 2 2 2 2 2 2 2 0 4 2 0 2 0 2 2 0 1 1 1 1 1 1 1 1 1 1 1 1 
1 1 1 1 1 1 1 1 1 1 0 2 2 2 2 2 2 2 2 0 0 2 2 4 19 10 4 2 2 0 4 2 2 2 2 2 2 0 1 1 1 1 1 1 1 1 1 1 1 1 
1 1 1 1 1 1 1 1 1 1 0 2 2 0 2 2 0 2 2 2 2 2 2 4 4 4 4 2 2 2 2 2 2 2 2 2 19 0 1 1 1 1 1 1 1 1 1 1 1 1 
1 1 1 1 1 1 1 1 1 1 0 2 2 0 2 2 0 2 2 2 0 2 2 2 2 2 2 2 2 0 4 2 2 2 9 2 2 0 1 1 1 1 1 1 1 1 1 1 1 1 
1 1 1 1 1 1 1 1 1 1 0 2 2 2 2 2 2 2 2 0 0 2 2 2 2 2 2 2 2 0 4 2 0 2 0 2 2 0 1 1 1 1 1 1 1 1 1 1 1 1 
1 1 1 1 1 1 1 1 1 1 1 0 2 2 2 2 2 2 0 0 0 0 2 2 2 2 2 2 2 0 4 2 2 2 2 2 2 0 1 1 1 1 1 1 1 1 1 1 1 1 
1 1 1 1 1 1 1 1 1 1 1 0 0 0 0 0 0 0 0 0 0 0 0 0 2 2 0 0 0 0 0 0 0 0 0 0 0 0 1 1 1 1 1 1 1 1 1 1 1 1 
0 0 0 0 0 0 0 1 1 1 1 0 0 0 0 0 0 0 0 0 0 0 0 0 2 2 0 0 0 0 1 1 1 1 1 1 1 1 1 1 1 1 1 1 1 1 1 1 1 1 
0 0 2 2 2 2 0 0 1 1 0 0 4 4 2 4 4 4 0 0 0 0 2 2 2 2 2 2 0 0 1 1 1 1 1 1 1 1 1 1 1 1 1 1 1 1 1 1 1 1 
0 2 2 2 2 2 2 0 0 0 0 4 4 2 2 2 2 4 4 0 0 2 0 0 2 2 0 0 2 0 1 1 1 1 1 1 1 1 1 1 1 1 1 1 1 1 1 1 1 1 
0 2 2 2 11 2 11 2 2 0 0 2 2 2 2 2 2 2 2 2 0 2 0 2 2 2 2 0 2 0 1 1 1 1 1 1 1 1 1 1 1 1 1 1 1 1 1 1 1 1 
0 2 19 2 2 2 2 2 2 2 2 2 2 2 2 2 2 2 2 2 2 2 0 2 2 2 2 0 2 0 1 1 1 1 1 1 1 1 1 1 1 1 1 1 1 1 1 1 1 1 
0 2 2 2 2 2 2 2 2 0 0 2 2 2 2 2 2 2 2 2 0 2 2 2 2 2 2 2 3 0 1 1 1 1 1 1 1 1 1 1 1 1 1 1 1 1 1 1 1 1 
0 2 2 2 11 2 0 0 0 0 0 4 2 2 2 2 2 2 4 0 0 2 2 2 2 2 2 2 2 0 1 1 1 1 1 1 1 1 1 1 1 1 1 1 1 1 1 1 1 1 
0 0 2 2 2 2 0 0 1 1 0 0 4 4 4 4 4 4 4 0 0 0 2 2 2 2 2 2 0 0 1 1 1 1 1 1 1 1 1 1 1 1 1 1 1 1 1 1 1 1 
0 0 0 0 0 0 0 1 1 1 1 0 0 0 0 0 0 0 0 1 0 0 0 0 0 0 0 0 0 0 1 1 1 1 1 1 1 1 1 1 1 1 1 1 1 1 1 1 1 1 
